efciente 	Positivo
otimo regular 	Positivo
bom excelente 	Positivo
gps ajuda bastante examino rotas üëçüòç‚ù§ 	Positivo
bom bom app 	Positivo
simplesmente 5 estrelas 	Positivo
boa forma orientacao carro pe etc 	Positivo
resto otimo 	Positivo
ha mto tempo procurava navegador gps off line eficienteeste superou mhas espectativaspodem baixare parabens desenvolvedores 	Positivo
maravilhoso simplesmente indispensavel todas horas 	Positivo
bom 	Positivo
otimo aplicativo 	Positivo
app bom 	Positivo
excelente app 	Positivo
otimo melhor app ja usei ate ape otimo leva agente certinho 	Positivo
mapas parabens otimo bem organizado 	Positivo
parabens desenvolvedores 	Positivo
melhor melhor incomparavel 	Positivo
otimo gps comunitario recomendo todos üëç 	Positivo
aplicativo bom gostei recomendo parabens desenvolvedores 	Positivo
melhor 	Positivo
gps bom 	Positivo
excelente deveria ter opcao excluir fotos conteudos irrelevantes pois clientes estao postando fotos produtos cadastro empresas 	Positivo
dignos elogios 	Positivo
app excelente 	Positivo
sempre atualizacoes podem baixar 	Positivo
otimo servico bom 	Positivo
otimo uso todos dias 	Positivo
bom 	Positivo
aplicativo mudou vida relacao itinerarios 	Positivo
bom 	Positivo
bom 	Positivo
duvida aplicativo seculo 	Positivo
melhor gps atual 	Positivo
top 	Positivo
bom quase sempre certo‚ò∫ 	Positivo
experiencia navegacao app sempre positiva 	Positivo
facil comecar usar muitas opcoes pra configurar voce gosta fucar previsoes tempo chegada destino sao boas atualizacao tempo real sas condicoes transito sao top 	Positivo
excelente 	Positivo
nota 10 	Positivo
pessoas perdem tempo weize google maps informa bem melhor caminho transito real rodovias pistas serio problema destes aplicativos esquenta demais celular 	Positivo
adoro salvou menos 3 paises 	Positivo
bom gostei 	Positivo
bom excelente 	Positivo
melhor navegador mundo nao vai qualquer lugar perfeito 	Positivo
bom gostando ajuda muitooo menos nao rotas lugares risco 	Positivo
pratico preciso 	Positivo
pra mim oculos nao saio casa super recomendavel melhor gps 	Positivo
bom maravilhosos aqui sao paulo capital interior melhorada hoje rua quer nao mao dupla hoje contra mao cidade muda transito voce nao acompanhar mudanca tempo real 	Positivo
parabens criou 	Positivo
bom 	Positivo
otimizado ficou legal versao "maps" aibda melhorar 	Positivo
melhor ate agora bom 	Positivo
escelente app 	Positivo
rua nao pavimentadalugares interior cidade onde recidoeste levou certinho sinal satelitesfuncionou offline parabensdei 4 estrela porqu√™ sempre pode melhorar elogiar demais estraga 	Positivo
nota maxima sempre 	Positivo
geral bom melhor gps transito ja experimentei so precisa melhorar busca endereco igual melhor google ter oposicao alarme sonoro velocidade ajudaria outra sujestao viavel utilizalo viajem longa nao perca mapa rede internet 	Positivo
app bom 	Positivo
excepcional melhor app mapas gps 	Positivo
bom parabens 	Positivo
bom achei ficou bom ultima atualizacao 	Positivo
bom 	Positivo
t√¥ gostando bastante app vcs pediram abrir app ja soubesse caminho avisaria radares etc 	Positivo
muitas vezes vou trabalho pra lugar nunca guia certinho 	Positivo
otimo 	Positivo
excelente navegadoresta beira perfeicaorapido opcao rotacontinuem assim desenvolvedoresobrigado 	Positivo
top üëèüëèüëè 	Positivo
comprei moto g5 plus ficou tudo perfeito bateria baixo consumo gps 	Positivo
melhor aplicativo offline ja vi recomendo 	Positivo
otimo ajuda diariamente todos percursos funciona bem sii 	Positivo
eh realmete bom 	Positivo
mt bom aplicativo 	Positivo
otimo 	Positivo
aplicativo perfeito consigo fazer absolutamente tudo preciso lugares distantes quer errar rua otimo pessoas reclamam sao pessoas querem aplicativo levem tente raciocinar minimo possivel 	Positivo
gostei 	Positivo
resto estao parabens 	Positivo
otimo s√≥ nao dou 10 estrelas pq nao 	Positivo
amei app 	Positivo
show nao perde 	Positivo
cel salvou mtos problemas qdo confie carro desatualizado so uso nunca perdi viajo ando lugares desconhecidos mostra acidente transito desvia pra caminhos rapidos top 	Positivo
maps cada vez melhor ajudar sempre falhas melhor app navegacao 	Positivo
satisfaz boom d 	Positivo
amei queria atualizasse hoje tempo moderno pq tou enjoado ver enfrente casa toalha kkkkk quiser ve turquia n 51 bairro jardim sao jorge lagoa campo grande mt 	Positivo
top preciso 	Positivo
adorei 	Positivo
bom 	Positivo
sempre bem ja testei portugal estados unidos utilizo diariamente paris 	Positivo
mto bom gostei 	Positivo
bom pratico viajar 	Positivo
continua bom 	Positivo
gostei bom app nunca deixou mao informa direito 	Positivo
bom app ajuda demais diaadia 	Positivo
otimo app 	Positivo
app bem util 	Positivo
legal bom 	Positivo
usando pouco tempo ja percebo bom app 	Positivo
gps completo 	Positivo
otimo 	Positivo
vale download 	Positivo
usei poucas vezes ate agora agradou bastante 	Positivo
bom 	Positivo
bom 	Positivo
bom aplicativo informa passa trajecto todos podemos contribuir viagem segurancatambem ja alguns contratempos aplicacao nada impede nao pontuacao 	Positivo
bom 	Positivo
gostei onde passei mostra radares caminho bem certinho 	Positivo
otimo aplicativo voce quiser pegar onibus errado perder ter caminhar 1h voltar casa 	Positivo
show bom facil manuseio 	Positivo
otimo 	Positivo
quero parabenizar criadores 	Positivo
bom melhor aplicativo navegacao carro 	Positivo
bom 	Positivo
bom 	Positivo
made my life so much easier while in london 	Positivo
aplicativo bom 	Positivo
bom nota 10 	Positivo
otimo 	Positivo
uso todos dias ainda surpreendo 	Positivo
app bom 	Positivo
uso horas todo dia 	Positivo
bom 	Positivo
bom aplicativo 	Positivo
show 	Positivo
bom vez perco todos pontos precisar formatar aparelho 	Positivo
inicio bom rodava ate longo caminho offline 	Positivo
otimo poderia ter opcoes offline marcar radares bloqueios assim rede transmitir informacoes 	Positivo
show excelente aplicativo 	Positivo
bom importante 	Positivo
otimo bom 	Positivo
bom otimizar tempo fugir engarrafamentos 	Positivo
bom 	Positivo
apps top linda 	Positivo
gostei bom aplicativo 	Positivo
app util sempre utilizo atende bem espectativas 	Positivo
adorei amo tudo 	Positivo
bom ajuda saber bom 	Positivo
b bom 	Positivo
app ja bom 	Positivo
nao vou ate padaria waze ligado 	Positivo
util 	Positivo
show 	Positivo
bussola 10 	Positivo
fiz pequeno teste gosteiagora nao sei avisa radares amanha vou viajar ver melhoro estrelas 	Positivo
excelente aplicativo melhor gps ja baixei rotas nitidas nunca deixou mao recomendou ainda nao precisa internet 	Positivo
bom cristo 	Positivo
parabens 	Positivo
melhor mundo ate agora 	Positivo
excelente grande utilidade visitantes 	Positivo
samsung galaxy note4 bom pratico facil usar recomendo 	Positivo
aplicativo bom 	Positivo
bom ajuda tr√¢nsito ja trabalho motorista recomendo todos 	Positivo
bom 	Positivo
cada vez melhor 	Positivo
app otimo principalmente off line 	Positivo
gps otimo 	Positivo
bom uso tempo 	Positivo
nivel erro minimo 	Positivo
ate momento gostando 	Positivo
otimo app recomendo usar 	Positivo
otimo perfeito 	Positivo
nunca deixou mao 	Positivo
ajuda 	Positivo
achei melhor wase maps ambos cheio frescurite 	Positivo
imbativel navegador 	Positivo
uso 	Positivo
gostei bom parece ser app bom vou testa certinho inquanto nao certeza 	Positivo
bom aplicativo 	Positivo
app cada vez melhor 	Positivo
so elogiar parabens equipe waze fica dica trabalho caminhao deveria ter opcao trajeto caminhao pos fica mandando vias principais caminhao nao pode trazitar sertas via 	Positivo
tudo google faz bom nada reclamar 	Positivo
app bom cada dia sido otimas melhorias 	Positivo
otimas rotas acho opcao adicionar parada simplesmente fantastico 	Positivo
bonzin 	Positivo
excelente excelente 	Positivo
melhor 	Positivo
gps otimo app 	Positivo
bom aplicativo 	Positivo
top 	Positivo
melhor gps simplesmente melhor app gps mundo 	Positivo
ajuda sempre 	Positivo
otimo 	Positivo
sinal operadora eh perfeito 	Positivo
app existisse uns 20 anos atras poupado meses ate anos preso transito 	Positivo
google completo todos sentidos 	Positivo
bom cumpri oque promete totalmente off levou destino tracou novas rotas problemas parabens 	Positivo
valeu 	Positivo
otimo 	Positivo
bom aprovei app 	Positivo
otimo 	Positivo
bom 	Positivo
excelente gps 	Positivo
util 	Positivo
gostei 	Positivo
gostei bom poderia ter alertas radar limites velocidade vias porque vezes nao sabemos velocidade via 	Positivo
tipo app otimo app souber usar 	Positivo
facil usar 	Positivo
amei app d+ app maravilhoso vc nao baixou baixe certeza vc vai 10 estrelas dou nota 10(dez) 	Positivo
facil melhor coisa 	Positivo
ameiiotimo aplicativonao trava aparelho obedece ordens gostei nova atualizacao 	Positivo
aplicativo fantastico permite inclusive fazer simulacao rota nao surpresas caminho 	Positivo
bom 	Positivo
otimo 	Positivo
otimo 	Positivo
excelente parceiro trabalho 	Positivo
bom 	Positivo
aplicativo bom recomendo 	Positivo
melhor 	Positivo
top nunca problemas sempre m orientou correto 	Positivo
menos nao perdo+ 	Positivo
aplicativo bom completo oferecendo opcoes diversas abrangendo varias regioes 	Positivo
bom 	Positivo
umas pequenas confusoes curvas retornos compreensivel caos brasileiro algumas cidades recomendo 	Positivo
otimo aplicativo 	Positivo
otimo recomendo 	Positivo
excelente 	Positivo
ja usei 4 viagens funcionou legal 	Positivo
fiz viagem 720 km sempre avisou radares certinhos 	Positivo
top 	Positivo
vai falando indicando tudo voc√™ olha dados nao gasta quase nada 	Positivo
otimo aplicativo bom 	Positivo
parabens criadores 	Positivo
atualizacao bom estar desatualizado mapa nao aparece retornos novos semaforos radares 	Neutra
falta via fluvial mora cidade onde transporte fluvial essencial aplicativo nao permite escolha desse meio transporte 	Neutra
volte opcao assim prefiro velho gps verificar transitoaff nao melhoram opcao inves remover 	Neutra
sempre usei gps entregas porem alguns enderecos nao estao certos tento entrar contato suporte nao consigo email suporte consta incorreto aguardo respostas equipe gps brasil 	Neutra
tanto aplicativo usando celular quanto conectado android auto 	Neutra
poderia ter possibilidade busca endereco mapa escolher destino diretamente mapa 	Neutra
√≥timo maes lento 	Neutra
vc deveriam informar favelas mapa dizer ser area risco 	Neutra
assim filma 2 arquivos externo interno 	Neutra
preciso app pra trabalhar alguem 	Neutra
falta ainda informacoes radares velocidades maximas vias 	Neutra
ja mandei inumeros feedbacks google nada 	Neutra
vou testar hoje nova atualizacao motociclistas 	Neutra
ter sinalizador alertas opcao areia curva 	Neutra
bom porem ja entrei favela causa deus nao ouve nada comigo coloquei caminho enviou lugar comoletamente diferente rota 	Neutra
marquinhos (marco luke) nunca deixou mao 	Neutra
precisamos percorrer ruasnao vai porque veiculo nao passou rua 	Neutra
duas estrelas porque ponto azul fica andando nao mostra localizacao correta pois parado lugar tipo casa trabalho ponto azul mostra outra localizacao rua algo assim consertem ai sabe darei cinco estrelas 	Neutra
nao assim meses atras 	Neutra
poderia ter antecipacao faixa via rapida marginal app so mostra manter direcao 	Neutra
caso portugalsuica deveria ser possivel obter rota/mapa poder descarregar poder navegar offline 	Neutra
so caminhada trem metropolitano transporta cidade pra outra 	Neutra
queria marcar trajeto passando desvio nao consegui 	Neutra
deveria permitir ditar regras percurso rapido pois vezes pais rapido nao economico 	Neutra
quebra ganho vezes 	Neutra
nome rua numero bairro cidade quantidade quilometros percorridos titulo viagem pra serem visualizadas agenda 	Neutra
aproximo demora bastante mostrar detalhes lugar usando wifi 	Neutra
prefeitura mapeadas areas risco favor incorporem informacao aplicativo 	Neutra
nao funciona nao desinstala 	Neutra
#voltaalessandra 	Neutra
sei melhorias estao acontecer breve menos assim espero 	Neutra
otimo aplicativo gostaria saber proxima atualizacao vai ter escolher modo veiculo vc caso carro caminhao 	Neutra
estranho talvez ser focado celular 	Neutra
menos celular deitado acontece 	Neutra
cuidado rotas indique menos tempo trajeto distancia pode fazer arrepender ter aceitado 	Neutra
falta opcao baixar mapa uso offline 	Neutra
deveria poder escolher rota rapida 	Neutra
so sistema voz 	Neutra
google nao oferece nada atualizado regioes interior exeplo: nao ha streetview cidades medicilandia brasil novo 	Neutra
porem sera seguranca todos nao so motoristas uber 	Neutra
desinstalei voltei pra versao antiga opcao rota curta 	Neutra
nao encontra alguns caminhos simples falta 1 mecanismo vc avisar transito naquele ponto acabou aviso interdicao via so esquina seguinte diante 	Neutra
aplicativo procura localizacao 	Neutra
nao uso fica atualizando toda hora queira precise ocupa espaco demais 	Neutra
vamos la aplicatico vamos la aplicativotem melhorarsei q podem issocorriga dados risco atualizar dados tbm mapa 	Neutra
observacao quanto localizacao radares br163 	Neutra
entao resposta vc motorista pode fazer rota" chega ser malcriada algumas situacoes 	Neutra
ter variacoes simbolos veiculos loja 	Neutra
descricao caminho waze avisar sequ√™ncia ap√≥s entrar via permitir posicionar faixas horarios fluxo 	Neutra
sempre bom antes perguntar pra alguem ja viajou lugares proximos realmente caminho melhor 	Neutra
preciso indicar area risco nome comunidade 	Neutra
nao adicionar casa devido nome rua bairro etc nao correto desatualizado 	Neutra
s√≥ falta modo offline dados moment√¢neos tr√¢nsito puder armazenar menos mapas google maps √≥timo 	Neutra
voces podiam fazem modo tela cheia pra evitar burnin modelos botao virtual 	Neutra
legal mostrase estradas nao assaltadas cores notificacao 	Neutra
colocar avisos radares existe exemplo waze 	Neutra
deveria permitir baixar trajeto navegar offline 	Neutra
tavares dificil 	Neutra
corrijam favor voltem ser melhor app 	Neutra
bom eventualmente moca fica muda nao indica caminho verbalmente 	Neutra
deveriam atualiza pois faz 7 anos n atualizam fotos casas n existem google existe realidade 	Neutra
deveria fica encima tamanho bom visualizacao 	Neutra
so acho deveria ter opcao numeros casas comercios 	Neutra
otimo porem muitas pessoas relatam sempre manda rua rua paralela avenida principal podendo colocar ruas esburacadas etc 	Neutra
fazer 	Neutra
vou testar hoje testar deixo comentario 	Neutra
posso resolver problema 	Neutra
leva ummilebio pra corrigir atualizar rota 	Neutra
alguma coisa possa fazer melhorar aguardo resposta 	Neutra
poderiam criar opcao cadastrarmos lombadas assim fazemos radares fixos 	Neutra
so simulador rota deveria ser simples pessoas acertarem funcionalidade 	Neutra
necessario hoje dia 	Neutra
carro vai subir descer escadas ate escadas estreitas proprio carro 	Neutra
aqui bh passando periodo chuvoso parar carro qualquer lugar pode ser sinonimo stress alagamentos 	Neutra
opcao usar smartphone dash can filmar trajeto possivel duas cameras smartphones boa pot√™ncia hardware 	Neutra
tomem cuidado app bom muitas vezes faz venhamos fazer zig zag causa 1 minuto menos 	Neutra
ainda nao sei funciona dados movel endereco correto ate agora 	Neutra
so deveria rever sinais gps rede q fica pedindo direto enquanto outros aplicativos funcionam normalmente restante tudo ok 	Neutra
funcionava perfeitamente apos algumas atualizacoes modo offline parou mostrar ruas avenidas aparece so gps antes perfeito 	Neutra
deveria avisar sempre visto voce nao fica dirigindo olhando mapa 	Neutra
otimo pago tipo veiculo 	Neutra
mostra radares acidentes precisos so ultimamente utilizando ir alguns locais nao preciso fez rota totalmente diferente algumas vezes mostra pouco confuso entrar determinadas ruas 	Neutra
so falta voz portuguesa feminina 	Neutra
coloquem opcao montar etinerarios diversos pontos parada melhor rota passagens pontos ia ser perfeito profissionais 	Neutra
informa precisao 	Neutra
cabeca pra baixo tbem pra entender 	Neutra
ja recebi comentarios motorista van escolar usando aplicativo motoboy ate caminhoneiro canal youtube 	Neutra
deixem maps navegacao carro formato seta igual wase 	Neutra
deveria ter informacoes sobre lugares perigosos favelas vias possamos sair dessas vias 	Neutra
melhorar indicar radares velocidade real movimento veiculo momento viagem 	Neutra
app eh bom porem precisa melhorar inicio navegacao lento atualizar nova rota circulo inicial atrapalha 	Neutra
so deveria ter opcao uso off line 	Neutra
melhoria imagens tempo real cidade interior aparece apenas uns matos construcao representando anos atras atualmente aqui cidade predio etc maps nao carrega 	Neutra
poderia ter pra deixar melhor 	Neutra
desative notificacoes continuam sons popups qualquer momento usar aplicativo 	Neutra
colocarem 2 itens ficara perfeito üëå 	Neutra
app deveria conciliar sugestoes trajeto horarios funcionamento balsas exemplo 	Neutra
informar lentidao local 	Neutra
sempre uso google maps falha vezes qdo uso rodovias onde trabalho 	Neutra
bom atualizar ser rapido 	Neutra
apesar exibir radar mapa sempre aviso sonoro sobre 	Neutra
deveria ter forma enviar avisos exemplo carro enguicado precisar teclar 	Neutra
poderiam mostrar alternativa rotas alternativas situacoes transito 	Neutra
vamos atualizar localizacoes ne maps 	Neutra
paguei valor tchau anuncios 	Neutra
pra poder usa off 	Neutra
deveria ficar sempre boas vozes opcao 	Neutra
boa ferramenta transitomais vezes fica louco faz caminho longos demora atualizar transito melhora atualizado vezes muda configuracoes sozinho 	Neutra
otimo agora coloco destino mostra rota nao acompanha deslocamento carro 	Neutra
segui sugestao trajeto maps cheguei local embarque balsa mesma nao horario funcionamento 	Neutra
inserir radares percurso limites velocidade seguranca vias sao itens necessarios 	Neutra
alem funcoes carroa peonibus trem deveriam coloca funcao caminhaopor favor deem forca garanto q pessoas irao usar app uso hora q so manda lugar errado ser carreta ai complica 	Neutra
ser mantido usuarios ficamos sabendo hora congestionamento acidente exemplo 	Neutra
bom porem nao pra baixar mapas cartao mem√≥ria botei tambem opcao baixar mapa inteiro brasil 	Neutra
espero resolvam 	Neutra
atualizado nao funciona 	Neutra
varias vezes retirar atualizacoes 	Neutra
toda vez busco endereco tento fazer caminho transporte publico maps aparece mensagem trajeto nao encontrado 	Neutra
resolver perda constante sinal 	Neutra
melhor gps brasil atualizacao ficou lento pesado demora calcular rota muitas rotas voltas desnecessarias motorista q trocar p waze q nao gosto incrivel q pareca rapido 	Neutra
falta colocar opcao radares reducao velocidade via opcao mapas carros motos caminhoes 	Neutra
deveriam atualizar veiculos pesados tbm 	Neutra
mensagens offline deveriam vir : informacoes 1hexemplo sempre internet trajeto atualizado informacoes 	Neutra
so falta funcao pra caminhoes geralmente sao rotas diferente iria ajudar trabalha transportes cargas 	Neutra
pergunta nao resposta kkkkkk 	Neutra
indicar areas risco 	Neutra
hoje marginal pinheiros limite velocidade velocidade 90 app ainda 70 subir ponte octamendez ficar pista local pegar ponte app mandou ir pista expressa passei ponte ficou pedindo retorna 	Neutra
circulo azul deixa tudo confuso mapa rotaciona adivinhar pra onde ir alguns instantes ate seta resolver aparecer 	Neutra
poderia melhorar modo recompensar contribuintes local guides 	Neutra
dependo gps servico 	Neutra
espaco pra atualizar 	Neutra
falta seguranca pra saber indentificar areas riscos bom parceria algum app tipo banco dados 	Negativo
ultima atualizacao ficou ruim achar enderecos corretos cidade 	Negativo
üò†üò†üò†üò†üò† nao gosto aff 	Negativo
semana duas situacoes desagradaveis relacao trajeto sugerido app 	Negativo
agora problema tempo todo sinal gps 	Negativo
considera tr√¢nsito recalcula rotas demoram tempo normal alguns casos faz rotas distantes normal momentos tr√¢nsito 	Negativo
pena litoral sul bahia precisamente br 327 sentido porto seguro nao reconhece radares fica desorientado trajeto 	Negativo
horrivel trava tempo todo 	Negativo
ja funcao gps acho bem fraca principais funcoes falta sao mostrar radares fixos mostrar velocidade permitida rua trafegando funcao offline deveria ser estado nao area agora 	Negativo
sendo rodovia perto fudi carro causa desse gps 	Negativo
ja reinstalei umas duas vezes nao resolve 	Negativo
motivo nao uso frequencia consumo gigantesco bateria 	Negativo
demora pra carregar navegacao 	Negativo
pena perdi voz luciana comprei moto g2 agora desativado 	Negativo
perdi evento rodei 600km atoa 	Negativo
vezes desligase aviso 	Negativo
falta urgente disponibilizacao mapas navegacao offline sao paulo visto nao sempre acesso internet movel (pessima qualidade sinal operadoras celular brasileiras) ta hora maps absorver funcoes waze (que adquirido google) informar radares acidentes etc 	Negativo
so vejo imagens antigas lugares dez anos atras 	Negativo
apos ultima atualizacao app orientou entrar contramao atravessar ruas acesso exclusivo pedestres subir "escadoes" 	Negativo
porem preciso ter cuidado pois pode definir tracados ruas zonas perigosas 	Negativo
creio melhorar motorista uber 	Negativo
demora atualizar acaba deixando preso transito 	Negativo
nao outro gps salvo smartphone nao chegado 	Negativo
bolinha azul inicio navegacao pessima 	Negativo
muita ruas bairros cidade nao existe mapa prejudica uso app 	Negativo
parando ja imprestavel pra mapa s√≥ 	Negativo
so fica meio estranho algo lugares rota continua erro caminho diferente 	Negativo
ja mexi configuracao nada resolveu 	Negativo
ainda precisa muita coisa antes bem melhor pq agente ia ate destino sair lugar agora nao opcao ainda existe muitas ruas agente nao consegue encontrar nao mostra nomes ruas proximas exemplo travessa cad√™ nome 	Negativo
gostava mto utilizar maps porem qdo troquei celular moto g play comecou travar acabar atrapalhando trajetos 	Negativo
dificuldade mudar rota vc sabe dum trajeto melhor nao mostra nomes ruas paralelas bom 	Negativo
rotas longas vezes necessidade retorno nao fica procurando rede internet pleno funcionamento 	Negativo
problema nao existia versoes passada 	Negativo
parar carro madruga ja algumas vezes mudar app google maps q sinal nao deixou mao ate agora 	Negativo
maioria vezes caminho/opcao indicada app fica caro e/ou distante 	Negativo
travando durante trajeto ta deixando mao 	Negativo
porcaria porcaria ja anos tento minimo ter mapa offline cidade (goi√¢nia) nao consigo pra abrir mapa online uso waze notificacoes acidentes blitz tr√¢nsito online 	Negativo
to avaliando ruim porque celula ta fucionando nao aparece mapa muda ingles portugues 	Negativo
demora nao encontra resolve problema 	Negativo
nao ta aparecendo rotas perto vc coloca pra ir pra lugar escolhe longe consertem rapido 	Negativo
vezes google mapas ajuda melhor trajeto sp bairro morumbi waze jogou dentro favela paraisopolis cortar caminhoqndo vi ja nao jeito sair 	Negativo
porcaria 	Negativo
atrapalha experiencia usuario 	Negativo
desisto realmente problema aplicativo 	Negativo
levando locais incorretos aplicativo bom ultimas vezes utilizei levada locais errados caminhos longos tr√¢nsito 	Negativo
nao funciona waze ja instalei desinstalei 2 vezes aplicativo ver funciona trava dizendo nao rede 	Negativo
acabei vir rio janeiro so passei apuros 	Negativo
ta falhando 	Negativo
informacao poderia ter salvado vidas passado pode salvar vidas futuro 	Negativo
nao recupera perfil 	Negativo
joga favelas 	Negativo
problema navegacao ja app utiliza mapa bem desatualizado uns anos atras 	Negativo
voce passa trajeto so mostra pra virar duas ruas antes 	Negativo
sempre usei app agora impossivel favor verificar 	Negativo
porem devera calcular nova rota nao informar pra retornar problema cidade vinhedo ate cidade campinas onde durante percurso vez continuar direto rod dom pedro i enviou pra cidade valinhos retornar pra mesma 	Negativo
beberrao demais 	Negativo
porem erro grave vi nele sao nomes ruas principais pequenos fica embaixo rota gps 	Negativo
ja bom muitos anos uso so vejo qualidade cair cada dia passa 	Negativo
‚≠ê‚≠ê‚≠ê rua quintino bocaiuva setorcampinas goi√¢nia goias final desta rua encontro av castelo branco contra nao ja gps rota mao certa multado la falta vcs atualizar rua 	Negativo
nao compensa sempre mostra rota dificil maior nao pratico 	Negativo
mapa nao atualiza fica sempre preto fiz procedimento sincronizar localizacao 	Negativo
questao informacao transporte publico ainda falta muita coisa melhorar 	Negativo
errou caminho 	Negativo
nao funciona sistema voz facilitaria navegacao reportar algum problema estrada ter fazer manualmente prejudica aplicativo 	Negativo
app so direciona rotas passando dentro favelas lins deu rota passando dentro jacarezinho outra passando complexo alemao ai f ne carioca conheco rio janeiro imagine nao daqui 	Negativo
contar demora pra mandar rotas alternativas manda rota certa ja passei proxima rua 	Negativo
tirem maldita bolinha azul 	Negativo
inicia rota demora pouco atualizar direcao correta atrapalha bocado trabalha todos dias aplicativo 	Negativo
ultimamente instavel 	Negativo
chato trava fecha todas vezes coloco rota 	Negativo
aplicativo travando 	Negativo
perde pro waze nesse sentido 	Negativo
gps falhando 	Negativo
momentos some 	Negativo
app deixou pontuar nao interfere usabilidade demonstra instabilidade 	Negativo
ultima atualizacao ficou ruim demora pra atualizar carrinho tela uber perdi duas corridas causa desse erro 	Negativo
sinceramente nao sei resolver 	Negativo
ja tentei configurar aplicativo sucesso 	Negativo
porem atualizacao atrapalha muitas vezes coloca apuros durante rota definida modo noturno pois dificulta visao google favor coloque disponibilidade alterar modo noturno diurno 	Negativo
pena 	Negativo
to enfrentando problemas procurar bairros recentes ds cidade 	Negativo
ia fazer rota mapa nao ia pra frente 	Negativo
desti jeito nao recomendo 	Negativo
trabalho uber ai antes apertava navegar ia certinho agora faz monte perguntas antes ir destino favor ver ae 	Negativo
funcionou 3 dias agora fica tela "baixando arquivos adicionais" nao sai disso gostaria solucao aguardando solucao dar estrelas 	Negativo
ponto fraco nao poder adicionar 10 paradas sistema bom	Negativo
icone ir pra frente andava direcionado pra frente percurso vinha pra tras 	Negativo
iniciar navegacao nao atualiza comeca dirigir so tempo 	Negativo
nao funcionando corretamente aparelho 	Negativo
preciso informacao precisa 	Negativo
precisa melhorar ainda problemas trava nao abre caminhos sempre maiores precisa ser sp din√Çmica nao pode perder tempo gastando comb 	Negativo
sempre manda entrar onde nao rua nao recalcula erro localizacao nao mostra velocidade fica sempre zero 	Negativo
aplicativo varios problemas toda vez voce fecha aplicativo perde toda configuracao inclusive dados usuario 	Negativo
decepcionado local guides 	Negativo
vezes nao encontra locais outros gps conseguem identificar facilmente 	Negativo
dificil acesso inicial 	Negativo
decepciona 	Negativo
problema conexao facebook sempre problema sai atualizacao 	Negativo
nao leva 5 estrelas 	Negativo
app nao funcionando 	Negativo
preferindo google maps 	Negativo
bom ultimamente tracando rotas piores faria conhecer caminho 	Negativo
lixo bosta 	Negativo
desde ultima atualizacao waze parou funcionar fica informando sinal gps 4g funcionando normal 	Negativo
deveriam dar ouvidos fizessem alguma mudanca vez acabam descredito ate desuso app 	Negativo
precisa melhorar bastante 	Negativo
talvez pouco tempo contato app achei pouco intuitivo forma pesquisar endereco destino 	Negativo
concertem 	Negativo
ajuda bastante ajuda bastante vira mexe deixa mao falta sinal rede 	Negativo
poderia nao ocupar grande espaco armazenamento rotas nao facilitam planejamento viagem relacao percursos linhas horarios mostrados transporte publicos 	Negativo
show tr√¢nsito ainda precisa melhorar pois ocasioes coloca lugares tr√¢nsito pior define pessimas rotas 	Negativo
usando google maps lugar wazer perdeu usuario atualizacao porca 	Negativo
hoje dia 0501 bem zuado sorte rotas curtas virando nao atualizada ponto gps movimento 	Negativo
pior app mapas existe 	Negativo
android atualizou 7 maps nao funciona corretamente 	Negativo
motorola x force nao funciona bug diz "sem sinal gps" 	Negativo
dirigindo visualizacao mapa cima dificulta entendimento 	Negativo
horrivel nao sei problema android ios funciona perfeitamente android nao abre nenhum mapa app fica instavel fecha sozinho nao funciona nada 	Negativo
piorou ultimas atualizacoes sempre coloco trajeto fica constantemente procura sinal gps deixou ser util 	Negativo
propagandas sao chatissimas tambem 	Negativo
ja melhor 	Negativo
ultima atualizacao acabou aplicativosou motorista uber waze nao consegue instalar linguagem fechavou ter q trabalhar mapsarrumem favor 	Negativo
desnecessario nota 3 	Negativo
lixo 	Negativo
cidade ainda nao encontra totalmente atualizado envia rotas longas dificeis 	Negativo
ultimas ficou ruim demais perdendo sinal sempre nao calcula rota eh pena respondem 	Negativo
google maps nao narrando trajeto durante navegacao 	Negativo
vezes traca uns caminhos ziguezague deixa puto 	Negativo
pessimo dessa nova atualizacaoo app nao abri direito nao consigo usar	Negativo
ruim 	Negativo
deixei usar 	Negativo
nao gostei tipo baixa mapa pega area ficou bem ruim assim vou pra outro aplicativo nao serve pra mim 	Negativo
melhor ultimamente anda travando comeca dar problema nao carrega fechar app abrir novamente problema nao telefone pois outros aplicativos continuam rodando perfeitamente 	Negativo
so nao dou cinco estrelas nao funciona bem offline here drive 	Negativo
ultima utilizacao ficou bosta ruim tao ruimestou usando outra vista google maps menos nao fica saindo sinal resumindo ta lixo 	Negativo
simplesmente porcaria 	Negativo
erros sentido transito rio janeiro certos pontos 	Negativo
trava nao sai mapa carregue botao sair continua mesma 	Negativo
cai sinal internet acaba waze 	Negativo
gps preferido nao mostrando radares ultimas atualizacoes app nao mostra pra direcao virado inicio viagens atrapalha 	Negativo
leva agora apos atualizacao ano abriros mapas estao erro cerca 300m localizacao correta 	Negativo
calcula tempo reacao app anos 2000 promove caminhos perigosos/duvidosos brasil parque tematico disney 	Negativo
falhoerra acerta endereco 	Negativo
apenas gps nada incrivel brasileiro nao perde mania estragar funcionando so ser vendido simplesmente acabo otimo agr üñìpelo menos servido orientacao ai vc v√™ acontecendo sevira maluco menos mal 	Negativo
fica sinal constante menti nao recomendo fica sinal toda hora melhor aruma 	Negativo
fazem uns dez meses trava direto zenfone 2 toda vez forcar parada 	Negativo
veracidade doa precos combustiveis horrivel 	Negativo
ola ano usuaria gps brasil aparelho porem pos ultima atualizacao sempre sinal gps tbm sinal fica voz som favor avaliada pq gosto apk 	Negativo
irritado maps todo momento tiro foto tenta postar publico ainda lugares nunca 	Negativo
antes bom 	Negativo
so amor deus tentando ir pro ceara dizendo so permitido distancia rota ate 1600 quilometros arrumem favor aumentar rotas ai pra possam melhorar ainda porque ai sim dou 5 extrelas 	Negativo
ha nao goste pois confunde muitas ruas 	Negativo
nao funciona on off line fiquei rodando igual peru tonto chegava ponto indicado trajeto sempre modificado levando lugar nenhum perdi uns 30 minutos ate dexisti usei outro app 	Negativo
leva agente pra outra rota 	Negativo
deixa q jeito q caramba 	Negativo
aqui arrasada 	Negativo
dificulta visualizacao mapa ta sempre escuro 	Negativo
infelizmente lastima perda dessa funcao 	Negativo
simplesmente horrivel demora eternidade calcular rota deveria ter opcao usuario escolher quer trabalhar modo noturno modo noturno horrivel dirigir deveria ter opcao desabilitar 	Negativo
caindo padrao qualidade 	Negativo
precisao ainda nao boa 	Negativo
ficou bolinha azul pessimo voltem antes agora deixo definitivamente usar 	Negativo
pontos tambem pararam ser contabilizados apesar rodar grandes dist√¢ncias carro 	Negativo
deveria mapear evitar areas risco menos alertar condutor vai entrar zona perigo 	Negativo
poderia melhorar navegacao( ficar parecido waze) 	Negativo
maps fica dando mensagens erro tento abrilo tambem nao abrindo 	Negativo
pessoal suporte devem arrumar app fica saindo sozinho tela iniciado trageto fica dando localizacao gps ta travando comeco comecei usar nao travava ficam mechendo app pra melhorar so ta piorando favor corrigem 	Negativo
pesa memoria lento 	Negativo
porcaria aqui nao serve gps 	Negativo
mudo 	Negativo
1toda hora aparece mensagem aplicativo parou responder 2 manda virar locais proibidos (o nao acontece waze) 	Negativo
excepcionalmente ruim 	Negativo
usava faziam anos horrivel agora impossivel usar 	Negativo
nao acerta horario onibus aqui natalrn 	Negativo
tempo inteiro dando erro 	Negativo
