bom 	Positivo
otimo app ajuda chegar locais nao conheco adorei 	Positivo
bom so faltando rotas alternativas 	Positivo
bom legal 	Positivo
excelente 	Positivo
bom aprovei app 	Positivo
familia amamos app 	Positivo
lenovo c2 bom tanto prova rapido eficaz pr√≥prio computador menos celular nao tava bugs etc 	Positivo
otimo poderia pedir pra voltar engano pegou caminho errado perguntar antes criar automaticamente outra rota 	Positivo
indispensavel uso waze trajetos conhecidos ja pode haver manifestacoes engarrafamentos etc 	Positivo
funciona bem 	Positivo
guia preferido utilizo sempre √≥timo todos aspectos 	Positivo
offline correto aqui 	Positivo
boa forma orientacao carro pe etc 	Positivo
bom 	Positivo
achei melhor wase maps ambos cheio frescurite 	Positivo
made my life so much easier while in london 	Positivo
otimo aplicativo bom 	Positivo
adoro wase 	Positivo
otimo aplicativo 	Positivo
uso horas todo dia 	Positivo
gps rapido confiavel 	Positivo
top grande ajuda campo trabalho so deveriam colocar opcao tipo 	Positivo
melhor conheco precisa melhorartem alguns problemas ca n√≥s nao nenhum tao completo 	Positivo
bom 	Positivo
otimo aplicativo 	Positivo
excelente uso quase 2 anos √≥tima opcao 	Positivo
olha waze pra min bom 	Positivo
valeu 	Positivo
bom gostei 	Positivo
bom gostando ajuda muitooo menos nao rotas lugares risco 	Positivo
imbativel navegador 	Positivo
bom üòÇüòÇ 	Positivo
ajudado bastante 	Positivo
bom 	Positivo
funcionava perfeito lumia 930 	Positivo
bom es gps 	Positivo
gostei bom 	Positivo
melhor 	Positivo
ganhando tempo tr√¢nsito bom 	Positivo
indispensavel uso waze trajetos conhecidos ja pode haver manifestacoes engarrafamentos etc 	Positivo
excelente 	Positivo
deixou vida pratica 	Positivo
super preciso 	Positivo
melhor gps duvidas completo melhor gps gratuito 	Positivo
bom 	Positivo
melhor ate agora bom 	Positivo
otimo app ajuda necessario 	Positivo
bom uso taxi 	Positivo
top 	Positivo
	Positivo
legal 	Positivo
gps incrivel 	Positivo
melhor aplicativo offline ja vi recomendo 	Positivo
perfeito bom 	Positivo
bom app 	Positivo
opiniao pessoal melhor aplicativo sistema gps gratuito hoje playstore 	Positivo
app si eh bom 	Positivo
aplicativo otimo 	Positivo
pratico preciso 	Positivo
excelente grande utilidade visitantes 	Positivo
bom 	Positivo
fiz viagem 720 km sempre avisou radares certinhos 	Positivo
procurando exatamente gps assim smartphone 	Positivo
sim bom 	Positivo
otimo ja usava oi mapas 	Positivo
app mto bom rotas sempre atualizadas 	Positivo
funcionando bem parabens 	Positivo
aplicativo ok 	Positivo
so elogiar parabens equipe waze fica dica trabalho caminhao deveria ter opcao trajeto caminhao pos fica mandando vias principais caminhao nao pode trazitar sertas via 	Positivo
bom bom 	Positivo
otimo aplicativo ajuda agente chegar 	Positivo
fiz pequeno teste gosteiagora nao sei avisa radares amanha vou viajar ver melhoro estrelas 	Positivo
ja preferido baixei mapas offline ativei modo wifi economizar dados agora so uso 	Positivo
melhor best 	Positivo
bom dahora 	Positivo
menos nao perdo+ 	Positivo
otimo 	Positivo
excelente aplicativo 	Positivo
bom 	Positivo
melhor mundo ate agora 	Positivo
vale download 	Positivo
pois gostei aplicativo ainda uso sync achei q gps brasil = melhor 	Positivo
bom s√≥ uso 	Positivo
bom parabens 	Positivo
estao parabens atendimento principalmente escutar opinioes usuarios 	Positivo
bom bom app 	Positivo
bom 	Positivo
bodyboader util 	Positivo
bom 	Positivo
bom 	Positivo
otimo app 	Positivo
show 	Positivo
app bom 	Positivo
gostei 	Positivo
otimo 	Positivo
gps ajuda bastante examino rotas üëçüòç‚ù§ 	Positivo
usamos app bom avisa ha foto sensor 	Positivo
nunca deixou mao 	Positivo
recomendo 	Positivo
aplicativo sempre auxilia bemum problemas verifiquei duas ultimas viagens fiz questao radares nao estao atualizados alguns pontos rodovia tamoios anhanguera 	Positivo
bom bom 	Positivo
bom show 	Positivo
bom funcional essencial 	Positivo
bom 	Positivo
otimo app mapas navegacao tempo real poderia possuir recursos alimentacao usuarios tecnicos transito facilitar locomocao funcionalidade transporte 	Positivo
geral app bom 	Positivo
app bom 	Positivo
atende todas expectativas 	Positivo
uso 	Positivo
bom 	Positivo
oferece promete 	Positivo
bom adorei uso toda viagens 	Positivo
gostei bom 	Positivo
nao enfia furada favelas 	Positivo
bom 	Positivo
waze otimo defeito 	Positivo
possibilidade salvar mapas off line aplicativo ficou show 	Positivo
otimo bom 	Positivo
app nota 10 msm net rota carregada continua mostrando rota haha show bola 	Positivo
nao vivo voc√™ mao roda 	Positivo
cada vez melhor 	Positivo
bom 	Positivo
excelente app pra ap 	Positivo
bastante satisfeito aplicativo 	Positivo
escelente app 	Positivo
recomendado uso sempre ja salvou diversas vezes 	Positivo
excelente aplicativo melhor gps todos ja usei rotas precisas nunca deixou mao nunca jogou lugares errados nao reclamar 	Positivo
bom excelente 	Positivo
legal demais 	Positivo
otimo 	Positivo
recomendo aplicativo nota dez 	Positivo
sergio menezes ola bom 	Positivo
bom 	Positivo
bom gps off line maravilhoso 	Positivo
excelente app pra ap 	Positivo
bom 	Positivo
sempre preciso ajuda nunca deixou mao 	Positivo
bom excelente 	Positivo
pessoal nao ficar comentado app nao merece todos elogiosta parabens app bom msm 	Positivo
radar 500m cinquenta klm horasfoi recomendar amigos 	Positivo
adoro waze ajuda bastante tracar melhores rotas 	Positivo
excelente show bola 	Positivo
primeira vez uso ida bem explicada 	Positivo
avaliar excelente 	Positivo
bom sempre ajuda 	Positivo
valeu 	Positivo
otimo opiniao disse contrario louco celular bosta so guenta rodar facebook 	Positivo
parece q resolvido perfeito 	Positivo
bom sempre uso 	Positivo
app fantastico 	Positivo
ja auxiliou muitas situacoes dificeis 	Positivo
aplicativo otimo pois faz varios avisos durante transito 	Positivo
arrumarem fica perfeito 	Positivo
bom 	Positivo
bom inteligente didatico 	Positivo
satisfacao 	Positivo
otimo 	Positivo
otimo bom 	Positivo
bom app parabens poderia ter funcao rotas caminhoes evitar q faca algum desvio dificil acesso subidas etc 	Positivo
melhor aplicativo offline ate agora usei 	Positivo
melhor tudo: editado usuarios tambem 	Positivo
precisao boa 	Positivo
waze excelente aplicativo auxilia dia dia 	Positivo
util 	Positivo
bom 	Positivo
excelente app 	Positivo
bom app ajuda 	Positivo
gostei 	Positivo
otimo regular 	Positivo
perfeito mostra velocidade via tela velocimetro melhor tudo tr√¢nsitose bom ruim 	Positivo
ai fica boa 	Positivo
10 vale pena 	Positivo
sempre ha melhorar ja bom 	Positivo
bom 	Positivo
andou melhorando dede ultima vez 	Positivo
gostei cumpre objetivos bom indicasse proximidade radares 	Positivo
mim otimo #curto bastante so detalhe vezes parados acha andando dai pede pra colocar passageiro 	Positivo
app bom cada dia sido otimas melhorias 	Positivo
samsung galaxy note4 bom pratico facil usar recomendo 	Positivo
incomparavel nao existe outro app compare categoria 	Positivo
otimo pratico preciso 	Positivo
excelente aplicatico recomendo todos 	Positivo
bom demais bem gostei 	Positivo
adorei bom conta pratico util 	Positivo
intencao boa 	Positivo
util pra mim dias comecou 	Positivo
perfeito dica voc√™s deviam botar ferramenta calcular quantidade combustivel gasta ponto outro 	Positivo
adorei 	Positivo
atual aparelho funcionamento perfeito 	Positivo
bom otima 	Positivo
bom 	Positivo
waze √≥timo aplicativo descricao taxista gostei nova versao 	Positivo
bom uso tempo 	Positivo
ajuda 	Positivo
otimo servico bom 	Positivo
excelente sempre tira tr√¢nsito pesado 	Positivo
otimo ajuda pq viajo brasil inteiro 	Positivo
mto bom 	Positivo
prefeito suprindo todas necessidades 	Positivo
agora posso andar pra todos lugares 	Positivo
bom 	Positivo
otimo parabens 	Positivo
top top 	Positivo
otimo 	Positivo
nao actualiza pontos bom 	Positivo
bom excelente aplicativo nao pesa cel deixa localizacao exata 	Positivo
informacoes uteis durante trajeto: transito tempos outras 	Positivo
b+ massa 	Positivo
bom amei 	Positivo
bom 	Positivo
bom aplicativo 	Positivo
bom 	Positivo
ja melhor 	Positivo
excelente excelente 	Positivo
bom 	Positivo
bom cumpri oque promete totalmente off levou destino tracou novas rotas problemas parabens 	Positivo
ultima atualizacao visual ficou bom excelente aplicativo 	Positivo
antes "desbravava" hoje visao geral quais caminhos poderei seguir 	Positivo
bom pratico viajar 	Positivo
pedagios deveria somar pedagios trajeto tambem perguntar queremos atualizar trajeto pois momento entra atualizar fica sinal operadora perdemos trajeto ja pre determinado 	Neutra
nao funciona voz informando radar acidentes 	Neutra
sugestao acho app poderiaassim aberto perguntar condutor carro passeio caminhao 	Neutra
alguns momentos fala outros fica mudo fazendo vc ver ouvir 	Neutra
bizarro google maps iphone funciona melhor android 	Neutra
problema ultima atualizacao fecha sozinho logo tento inicializar aplicativo 	Neutra
precisa atualizar novos mudancas mapa cidades so lugares casa atualizado tudo porque ja mudou visual lugares novos aplicacao presente 	Neutra
bom ficar atento ver mapa antes sair casa 	Neutra
resolver perda constante sinal 	Neutra
"nativo" celular p baixar mapas 	Neutra
vc deveria colocar radares fixos moveis ai ficava top nao colocar ser pontual tambem 	Neutra
google bem poderiam atualizar nomes ruas street view aqui 	Neutra
so deveria ter opcao uso off line 	Neutra
deveria avisar sempre visto voce nao fica dirigindo olhando mapa 	Neutra
favor coloquem opcao baixar rota inteira estado outro qualquer lugar brasil 	Neutra
plataforma forte porem interesses 	Neutra
sempre uso google maps falha vezes qdo uso rodovias onde trabalho 	Neutra
onde exatamente fica boca fumo vc nao desavisado determinado local 	Neutra
paguei valor tchau anuncios 	Neutra
agora voces podem incrementa icone aba pra marcamos lugares ja visitamos linkar google trips assim vai virar vicio querer deixar tudo marcado visitar tudo mundo jogo fim ü§î 	Neutra
usuario safado inserindo informacao errada proposito 	Neutra
pesquiso lugar menu contribuicoes aparece lugar avaliar visitado local nao acho correto melhor pedir avaliacao caso visitado local 	Neutra
sugiro apenas ficar melhor navegante pudesse selecionar veiculo 	Neutra
classe caminhao acho falta atualizacao ajudar motoristas caminhoes informacoes sobre vias tr√¢nsito restrito horarios restricoes 	Neutra
possivel implementarem funcao 	Neutra
outra sugestao poder tracar percurso pe offline 	Neutra
ultimas atualizacoes velocidade nao batendo velocimetro carro ja testei outro carro tbm nao internet porque passa radar marca velocidade bate carro waze uns 5 4 km baixo 	Neutra
voces podiam fazem modo tela cheia pra evitar burnin modelos botao virtual 	Neutra
indicar areas risco 	Neutra
nao funciona nao desinstala 	Neutra
bom nao dependesse internet 	Neutra
informar mudanca sentido via 	Neutra
agora att vou verificar 	Neutra
estao caminho 	Neutra
fica tudo atras janelas 	Neutra
titulo exemplo criacao pasta "restaurantes" onde possivel guardar nessa mesma pasta localizacoes restaurantes interesse 	Neutra
deveria perguntar queremos atualizar trajeto 	Neutra
caso portugalsuica deveria ser possivel obter rota/mapa poder descarregar poder navegar offline 	Neutra
prefeitura mapeadas areas risco favor incorporem informacao aplicativo 	Neutra
parece estar ponta cabeca 	Neutra
deveria poder escolher rota rapida 	Neutra
propria voz gps (um aplicativo externo pra fazer caso) ganhar pontos ajudar melhorar mapa trocar itens 	Neutra
nao funciona rede gprs edge operadora tim 	Neutra
deveria fica encima tamanho bom visualizacao 	Neutra
espero corrijam pois comentarios problema parece ser motivo reclamacao varias pessoas 	Neutra
nao encontra alguns caminhos simples falta 1 mecanismo vc avisar transito naquele ponto acabou aviso interdicao via so esquina seguinte diante 	Neutra
bom maps s√≥ reconhece metade avenida luiz gushiken (m'boi mirim) leva 4 estrelas 	Neutra
abro aplicativo celular trava 	Neutra
haver jeito nao esquentar tantonos ajudem 	Neutra
vou pedir uber app trava :/ 	Neutra
so falta coisa 	Neutra
agendaonde cadastraria carregariamos arquivo enderecos automaticamente lancaria tela ordem proximidades tracaria rota 	Neutra
pra entao serve opcao 	Neutra
podia atualizar sistema ta tudo casas antigas casas nao tao sao hoje 	Neutra
nao navegando tbm s√≤ fica bolinha azul ando carro fica perdida celular samsung j7 prime 	Neutra
lugares nao acessoe app indicar sim lugares agora constar pedagioe app indicar nao semana dois pedagio 	Neutra
ultima vez utilizei alternava rota razao aparente voce seguindo navegacao aplicativo 	Neutra
ideal nestes casos deixar celular fixo rede 3g 	Neutra
vamos atualizar localizacoes ne maps 	Neutra
sinal operadora celular ja trava vc vai seguir placas sinalizacao informando br nao vc ta rolado 	Neutra
preciso fazer curso vcs 	Neutra
digito endereco quero ir acha rua nome outras cidades 	Neutra
bom eventualmente moca fica muda nao indica caminho verbalmente 	Neutra
nao falo so mim falo todos local guides contribuem maps ficar melhor receber fato merecem 	Neutra
s√≥ faltou indica radar mostra velocidade 	Neutra
porem sera seguranca todos nao so motoristas uber 	Neutra
enquanto nao corrigirem continuarei usando waze 	Neutra
√ë fala dist√¢ncia correta ate local 	Neutra
bom ja levou barranco 1 vez demora obter localizacao correta autom√≥vel 	Neutra
circulo azul deixa tudo confuso mapa rotaciona adivinhar pra onde ir alguns instantes ate seta resolver aparecer 	Neutra
aplicativo bom ate ultima atualizacao porem agora nao funciona navegacao fica parado vc faz rota nao acompanha nao fica triangulo navegacao 	Neutra
so falta funcao pra caminhoes geralmente sao rotas diferente iria ajudar trabalha transportes cargas 	Neutra
precisamos percorrer ruasnao vai porque veiculo nao passou rua 	Neutra
deveria ter navegacao off line voz necessidade fazer download area 	Neutra
colocar opcao desativar modo noturno 	Neutra
otimo pago tipo veiculo 	Neutra
porem conectada ambos vezes ate wifi erro 	Neutra
radar nao aplicativovia lagos linha vermelha ta faltando algunsperto galeao 	Neutra
mostra radares acidentes precisos so ultimamente utilizando ir alguns locais nao preciso fez rota totalmente diferente algumas vezes mostra pouco confuso entrar determinadas ruas 	Neutra
mensagens offline deveriam vir : informacoes 1hexemplo sempre internet trajeto atualizado informacoes 	Neutra
nao consegui alterar visualizacao horizontal padrao navegadores gps 	Neutra
mylink 2 android auto face obrigatoriedade uso farol baixo rodovias durante dia google maps assume modo noturno forma automatica ligar farol atrapalha visibilidade 	Neutra
ja 4 vezes determinado lugar todas vezes trajetos diferentes assim nao consigo aprender melhor percurso 	Neutra
volta locucao luque dou 5 estrelas 	Neutra
poderia avisar proximos comunidades 	Neutra
utilizo waze so vezes joga rotas proibido caminhao 	Neutra
app nao interrompe musica radio cd pendrive anunciar direcoes 	Neutra
sugestoes: permitir download rota offline 	Neutra
pq todo mundo usa pra sair engarrafamentomuitos usam pra saber caminho 	Neutra
amo app sempre ajuda vezes preciso consultar caminho sei ir ate determinado local nao consigo pesquisar partir desse local ate destino final tipo nao tal local tal lugar ajudava 	Neutra
pq nao desde comecei utilizar outros meios transporte (uber/cabify) nao aparece opcao transporte publico 	Neutra
deveria atualizar ruascasas etc 	Neutra
sugestao ordenacao data postagem comentarios atual antiga 	Neutra
menos bom 	Neutra
nao pontuado ha tempos 	Neutra
voces poderiam criar opcao caminhoes poderiam criar opcao trabalha caminhao rotas alternativas seguras estradas onde proibido trafegar pesados outras coisas 	Neutra
porem travou algumas vezes corrigindo detalhe completo 	Neutra
sugestao alterar cor tela waze ate passar radar 	Neutra
espaco pra atualizar 	Neutra
ser mantido usuarios ficamos sabendo hora congestionamento acidente exemplo 	Neutra
caminhos distinguem zonas risco 	Neutra
ser perfeito so falta ser rapido tracar nova rota fazer curva 	Neutra
podia ter opcao colocar parada trajeto salvar rotas offline 	Neutra
celular nao problemas 	Neutra
tanto aplicativo usando celular quanto conectado android auto 	Neutra
nao ha opcao rota curta so leva consideracao engarrafamento vezes pra fugir outra rota longa melhor rota sendo maior 	Neutra
entretanto acho funcao avisa presenca policiais deveria ser excluida pois favorece pessoas estao cnh problemas sequestradores ladroes etc 	Neutra
poderiam criar opcao cadastrarmos lombadas assim fazemos radares fixos 	Neutra
entao resposta vc motorista pode fazer rota" chega ser malcriada algumas situacoes 	Neutra
gostaria sugerir mapa offline pudessem disponibilizar trajeto pe trajeto usando transporte publico grande utilidade 	Neutra
waze melhorar mudo avaliacao 	Neutra
acendimento app entende noite entanto nao acaba atrapalhando visualizacao sistema multimidia carro (que espelhamento app) 	Neutra
atualizacao necessaria informando caminho incorreto 	Neutra
poderia ter indicacao lugares perigosos dizer distancia upp proxima 	Neutra
seta navegacao deve aparecer desde inicio navegacao 	Neutra
pena ja google "obriga" usalo nao permitindo muitos casos escolha app navegacao 	Neutra
poderia melhorar visualizacao navegacao 	Neutra
bom atualizar identificar postos gnv busca "posto combustivel" 	Neutra
porque muitas vezes ate metade caminho sei ir nao consigo pesquisar antes estar local 	Neutra
pra locais proximos ate 	Neutra
entrem contato agencias correioa fazem ajuste corretamente 	Neutra
ter voz 	Neutra
falta implantar velocimetro indicacao radares coisa waze desde inicio 	Neutra
avisa aproximacao radares fixos velocidade permitida 	Neutra
pratico porem sinal internet fraco google maps bem melhor 	Neutra
falta waze calculo gasto combustivel (km/l) informacoes pedagios rota valor 	Neutra
sei melhorias estao acontecer breve menos assim espero 	Neutra
acho deveriam trabalhar areas tambem 	Neutra
nao tao preciso procurar endereco cidade 	Neutra
vi outros usuarios reclamando sobre informacoes erradas administradores app informando recepcao gps so todos entao 	Neutra
usando espelhamento android auto mylink carro (multimidia original chevrolet) ligar farois mapa fica tema noturno 	Neutra
desinstalando vou comecar usar google maps 	Negativo
desrespeito usuario 	Negativo
vou procurar outro app possa ajudar ate voces recobrem juizo traga bom app volta üò≠ 	Negativo
usava moto g4 dava sinal satelite errava localizacao 	Negativo
problema gps desde actualizacao recente nao alcanca sinal gps ate perde sinal 	Negativo
gostava mto utilizar maps porem qdo troquei celular moto g play comecou travar acabar atrapalhando trajetos 	Negativo
preciso informacao precisa 	Negativo
muitos erros muitos 	Negativo
nao gostei tirado opcao escolher percurso rapido percurso curto 	Negativo
todas vezes troquei celular nao pra recuperar conta antiga acha logo aparece problema fazer nova 	Negativo
dirigindo visualizacao mapa cima dificulta entendimento 	Negativo
foda ruim galera aplicativo ruim fala po re oidicupa xega 	Negativo
nao sei conseguem proeza estragar app bom 	Negativo
ultima atualizacao dando problemas bugs gps mapa nao gira pro lado indo 	Negativo
waze hora falha aplicativo gps bom ser usado hora falha demora reiniciar fica rede direto gente trabalha aplicativo motorista muitos estao fazendo reclamacao estao deixando usar waze usar maps demora demais reiniciar localizar ta demorando ver voces conseguem dar melhorada nele 	Negativo
trava demais 	Negativo
todo trajeto trava fecha sozinho uns 500 metros antes chegar destino entao q ver memorizar rota pouco antes chegar pq depender app paro 3 esquinas antes fico la 	Negativo
tambem bolinha hora iniciar dirigir nao ajuda nada pois gente nao sabe rumo gente deve iniciar 	Negativo
desatualizado olhar hj dia 03/12/2017 umas fotos localizacao tudo antigas tanta atencao app ainda continua passado 0 estrela 	Negativo
dentro carro 3h30 cheguei niteroi manilha 	Negativo
software lento muitas vezes operadora sinal porem aplicativo aparece procurando sinal 	Negativo
horrivel 	Negativo
voces aumentaram indicacoes escritas atualizacao prejudicando navegacao 	Negativo
so informacao area risco nao informacao suficiente 	Negativo
voce passa trajeto so mostra pra virar duas ruas antes 	Negativo
horrivel 	Negativo
porcaria aqui nao serve gps 	Negativo
prejudica usuario 	Negativo
pra poder acessar dados perfil desinstalar instalar novamente 	Negativo
so atualizar algumas coisas 	Negativo
cai sinal gps demora atualizar rota vc sai percurso 	Negativo
indignado 	Negativo
mapa nao atualiza fica sempre preto fiz procedimento sincronizar localizacao 	Negativo
baixei tom tom mapas sim bom ainda rua engarrafamento faz desvio rota 	Negativo
deixa mao 	Negativo
bosta 	Negativo
agora sai rota sempre fica recalculando direto ja fez cair lugares perigosos 2x 	Negativo
problema ocorre dirigindo nada aparece propaganda atrapalhar visao mapa 	Negativo
nao avisa sobre area risco carrega eternamente 	Negativo
so nao dou cinco estrelas nao funciona bem offline here drive 	Negativo
alem fazer rotas ruins 	Negativo
navegacao lugares desconhecidos inferior google maps 	Negativo
ficou ruim 	Negativo
manda trajeto longo pede pra fazer volta quadra sendo destino a100 metros faz entrar favela trajeto 10minutos leva 45minutos demora pra abrir bom causa radares melhorar pouco 	Negativo
ultima atualizacao transito faz direcionamento ruas pequenas estreitas dentro bairros nao utiliza principais fazendo rota ficar demorada 	Negativo
so nessa ultima atualizacao deixou grande falha questao orientacao voz nao funciona favor equipe arrumem nao permanece bug resolver ai sim darei 5 estrelas 	Negativo
atrapalha experiencia usuario 	Negativo
fica s√≥ tela apresentacao 	Negativo
nao sei ta acontecendo app ultimamente anda travando gps nao atualizado nao dando caminho correto ruas saidas obras caminho volta pra tras atualizar gps caminho estavamos favor revolver anda mim prejudicando 	Negativo
ainda precisa muita coisa antes bem melhor pq agente ia ate destino sair lugar agora nao opcao ainda existe muitas ruas agente nao consegue encontrar nao mostra nomes ruas proximas exemplo travessa cad√™ nome 	Negativo
pois acham rede social importante trajeto 	Negativo
nao dando zoom virando mapa visualizacao 	Negativo
preciso atrapalha 	Negativo
antes bom 	Negativo
poderia ser melhor 	Negativo
so nao dou maisüå†porque vezes trava entao demora pra carregar 	Negativo
ja melhor hj mim piorpor ser online deveria ser preciso porem sinal celular perfeito gps perde sinalacusa outro lugar nada vermuita atualizacao desnecessarios estragou app 	Negativo
odiei gps mandou inumeras vezes p lugar errado gastei horrores gasolina 	Negativo
diz teste 3 semanas nova atualizacao motociclistas rotas estao meio burras dando voltas desnecessarias nao ainda alertas ajudam motociclistas areia oleo pista chuva 	Negativo
aplicativo travando 	Negativo
apos atualizacao app nao vem funcionando bem desinstalar instalar novamente ver funciona caso contrario usar outro app 	Negativo
fechando abrindo app nao captura sinal gps 	Negativo
ponto azul vezes mexe 	Negativo
resumindo inutil 	Negativo
acho ruim vc recebe localizacao aplicativo pede 3 confirmacoes poder comecar rodar 	Negativo
baixei outro aplicativo mostra posicao correta 	Negativo
porcaria botei destino beira mar parar boca fumo quase roubado moro fortaleza localizacao tava sul pais 	Negativo
toda hora "sem sinal gps" 	Negativo
vezes nao captura sinal gps faz abra mapsocorre normalmente ligo desligo gps celular visando economia bateria 	Negativo
ridiculo 	Negativo
so nao navegando aplicativo enquanto ouvir musica porque tende desligar mp3 gostaria saber porque nao posso utilizar aplicativo ja telefone multifuncional 	Negativo
pena retiraram voz marco luque 	Negativo
pessimo dessa nova atualizacaoo app nao abri direito nao consigo usar	Negativo
ja melhor 	Negativo
maioria vezes caminho/opcao indicada app fica caro e/ou distante 	Negativo
nao efetua preciso muitissimo obrigada 	Negativo
entao prejudicando bastante 	Negativo
nessa atualizacao ficou ruim usa celular deitado 	Negativo
vezes fica lento 	Negativo
leva agente pra outra rota 	Negativo
porcaria porcaria ja anos tento minimo ter mapa offline cidade (goi√¢nia) nao consigo pra abrir mapa online uso waze notificacoes acidentes blitz tr√¢nsito online 	Negativo
ficou ruim 	Negativo
questao informacao transporte publico ainda falta muita coisa melhorar 	Negativo
unico polema toda hora pede ajustar busula 	Negativo
travando durante trajeto ta deixando mao 	Negativo
pena 	Negativo
mudou tudo nao consigo ver horario onibus finais semana aparecendo apenas segunda sextafeira ficou bosta ajudem 	Negativo
continuam insistindo desgraca bola azul joga verdadeira loteria pra apostarmos acertarmos nao direcao correta pra seguir 	Negativo
ja bom muitos anos uso so vejo qualidade cair cada dia passa 	Negativo
regular ficou lento dessa atualizacao 	Negativo
so problema facil ser arqueado 	Negativo
1toda hora aparece mensagem aplicativo parou responder 2 manda virar locais proibidos (o nao acontece waze) 	Negativo
ja otima 	Negativo
nao funciona on off line fiquei rodando igual peru tonto chegava ponto indicado trajeto sempre modificado levando lugar nenhum perdi uns 30 minutos ate dexisti usei outro app 	Negativo
precisa melhorar ficar ruim 	Negativo
"tarja preta" indicativa proximas conversoes terrivel 	Negativo
nao funciona sistema voz facilitaria navegacao reportar algum problema estrada ter fazer manualmente prejudica aplicativo 	Negativo
ficou pessimo atualizacao 	Negativo
falta precisao 	Negativo
porem apos ultima atualizacao nao opcao caminho curto rapido navegacao deste dias atras mandou via rapida passava favela saia av hebe camargo 	Negativo
voces atualizam tanto estao estragando aplicativoagora ja faz uns tres meses fica aparecendo mensagem gps sinal aqui pinhais parana dificultando chegarmos lugaresnao problema internet favor tentem concertar 	Negativo
varias ruas numeros q nao batem local precisar ser atualizado acertar fica perfeito 	Negativo
sempre acertando caminhos so nao pode ter favela porque adora passear nelas coisa turista 	Negativo
perder sinal gps leva eternidade pra reiniciar desliga conta propria impraticavel 	Negativo
viagens nao possui cobertura paramos abastecer mexemos celular alguma coisa perde rota nao possivel recalcular novamente 	Negativo
unico defeito vezes sinal some demora pouco voltar funcionar 	Negativo
horrivel endereco aparece errado 	Negativo
diz q lugar nada ver onde realmente 	Negativo
demora agilidade durante uso 	Negativo
ja bom app 	Negativo
nao consigo localizar 	Negativo
vez desliga sozinho dar nenhum comando precisam corrigir 	Negativo
dificuldade mudar rota vc sabe dum trajeto melhor nao mostra nomes ruas paralelas bom 	Negativo
app ainda escolhe radares avisar sonoramente trava bastante ads sao invasivos 	Negativo
ja tentei novas configuracoes nao adiantou 	Negativo
android atualizou 7 maps nao funciona corretamente 	Negativo
dificulta visualizacao mapa ta sempre escuro 	Negativo
veracidade doa precos combustiveis horrivel 	Negativo
poderia melhorar navegacao( ficar parecido waze) 	Negativo
ja quase acidentei horrivel 	Negativo
horrivel nao sei problema android ios funciona perfeitamente android nao abre nenhum mapa app fica instavel fecha sozinho nao funciona nada 	Negativo
rotas longas vezes necessidade retorno nao fica procurando rede internet pleno funcionamento 	Negativo
precisa melhorar ja caminho 2018 app ainda 2000 	Negativo
oq ainda falta poder incluir duas rotas pois so duas fica dificil poderia melhorar ne 	Negativo
manda virar esquerda direita 	Negativo
sinceramente nao sei resolver 	Negativo
porem consome muita bateria pacote dados 	Negativo
nao recupera perfil 	Negativo
dificil acesso inicial 	Negativo
deixa desejar termos fluidez claro depende configuracao celular 	Negativo
sempre usei maps infelizmente nao mostra percurso visao terrestre apenas visao aerea tornando trajeto tanto quanto complicado 	Negativo
app deixou pontuar nao interfere usabilidade demonstra instabilidade 	Negativo
hj dia perdeu qualidade 	Negativo
moto maxx: complicando facilitando ultimamente tracando rotas aleat√≥rias uso ia calculo melhor percurso 	Negativo
deixou mao varias vezes 	Negativo
sempre manda entrar onde nao rua nao recalcula erro localizacao nao mostra velocidade fica sempre zero 	Negativo
cada atualizacao entra fica cada vez pior 	Negativo
so pra caminhoneiro complicado vc nao colocaram programa especifico pra caminha joga gente lugar nao pode passar caminhao ruas cabe caminhao puderem melherom abraco 	Negativo
agora travando internet boa regiao deixa mao 	Negativo
irritado maps todo momento tiro foto tenta postar publico ainda lugares nunca 	Negativo
alerta visual aparece atualmente nao chama atencao motorista 	Negativo
mostra localizacao totalmente errada todo momento fica mudando lugar vezes marca localizacao certa alguns minutos muda totalmente lugar aleatorio cidade ja fiz tudo 	Negativo
pessimo 	Negativo
trava varias vezes nao causa internete 	Negativo
poxa aplicativo nao reconhece diferenca pista lateral pista central rodovias 	Negativo
s√≥ pq nao outro pessimo porem waze pior 	Negativo
ta pessimo tela fica coberta parte superior parte abaixo aplicativo tampando assim visibilidade mapa rota 	Negativo
alerta radar alguma curva esquerda nao ver trajeto mapa 	Negativo
contudo eventualmente travada aplicativo momentos voce perdido justamente precisando funcionamento pleno 	Negativo
desti jeito nao recomendo 	Negativo
so dia pro outro opcao rodizio sumiu waze 	Negativo
opiniao demora mostrar direcao tb faz muitas voltas caso erros trajetos ex: n pede retornar imediato fazendo quer vamos apenas frente inves voltarmos 	Negativo
sai 5 estrelas 3 decepcao 	Negativo
rotas nao andam acordo veiculo 	Negativo
piorou ultimas atualizacoes sempre coloco trajeto fica constantemente procura sinal gps deixou ser util 	Negativo
nao funcionandi cono antes atrasa nao posicao correta todos lugares 	Negativo
atualizar 	Negativo
so nao mostra faixa 	Negativo
ficar fechando sozinho pena nao funcione apenas gps fazendo download rotas tal poderiam adicionar gnv opcoes combustiveis postos opcao 	Negativo
fiquei pouco preocupado app levou lugar diferente 	Negativo
ajuda bastante ajuda bastante vira mexe deixa mao falta sinal rede 	Negativo
ultimamente instavel 	Negativo
ja bom agora ta dando muitos erroso aplicativo nao mostra trajeto certoajeitem melhorar 	Negativo
voltem seta inicial pois bolinha so atrapalha 	Negativo
bom pena s√≥ deixar reportar algum acontecimento cima local pois assinalamos algo passando fica sitio 	Negativo
segundo qualidade mapas deixa desejar 	Negativo
nesta ultima atualizacao nao aparece automaticamente seta indica local trajeto 	Negativo
vou tentar atualizacao pois atualizacoes anteriores bugs pois colocavam m ruas saida tempo chegada destino dando muitas discrepancias 	Negativo
ate google maps ja opcao adicionar varias paradas organizalas 	Negativo
	Negativo
modo geral deixa desejar 	Negativo
atualizacao recente parou dar imagem posicao primeira pessoa fica dificil localizar dirigir 	Negativo
porem ja rodei so hoje 200km assim aplicativo ainda diz preciso andar 160km quero atualizar precos postos combustiveis nao consigo so causa disso 	Negativo
infelizmente nao igual navegador precisa deixar identico 	Negativo
nao consigo usar ps 	Negativo
