otimo 	Positivo
waze salva vida bom hj ja faz parte todas saidas carro nao sair nao ligar antes 	Positivo
otimo 	Positivo
bom sempre atualizado 	Positivo
otimo alguns problemas atualizacao agora perfeito 	Positivo
parabens desenvolvedores 	Positivo
bom cristo 	Positivo
precisao eh incrivel 6 estrelas 	Positivo
duvida aplicativo seculo 	Positivo
achei eficiente 	Positivo
simplesmente cumpre promete util 	Positivo
deixou vida pratica 	Positivo
otimo aplicativo perfeito funciona bem 	Positivo
bom 	Positivo
ajuda 	Positivo
bom 	Positivo
valeu 	Positivo
ajudado bastante 	Positivo
nao utilizei todos recursos desse aplicativo nao problemas ate presente momento 	Positivo
app excelente 	Positivo
otimo melhor app ja usei ate ape otimo leva agente certinho 	Positivo
bom 	Positivo
bom sempre ajuda 	Positivo
bom 	Positivo
bom só uso 	Positivo
ameiiotimo aplicativonao trava aparelho obedece ordens gostei nova atualizacao 	Positivo
inteligente funcional pratica 	Positivo
otimo app alem funcionar internet aplicativo conectado rede informa transito otimo nao 3g pois posso abrilo casa ver transito ja calcular melhor rota nota 10 desenvolvedores 	Positivo
app excelente 	Positivo
melhor 	Positivo
bom poderia qdo radares caminho avisar som sonoro nao so aparecer aviso radares tela ai sim perfeito 	Positivo
excelente navegadoresta beira perfeicaorapido opcao rotacontinuem assim desenvolvedoresobrigado 	Positivo
recomento todos 	Positivo
otimo 	Positivo
bom 	Positivo
melhor 	Positivo
bom aconselho 	Positivo
ponto positivo destaca concorrencia avisar radares 	Positivo
bom 	Positivo
ideia imagens local util pois ajuda encontrar enderecos nunca ido antes 	Positivo
viagem sao paulo minas gerais problema algum precisao informacoes otimas bom 	Positivo
gps completo 	Positivo
gostei bom poderia ter alertas radar limites velocidade vias porque vezes nao sabemos velocidade via 	Positivo
bom 	Positivo
otimo 	Positivo
excelente aplicativo melhor gps todos ja usei rotas precisas nunca deixou mao nunca jogou lugares errados nao reclamar 	Positivo
parabens criou 	Positivo
tô adorando uso gps brasil ha tempo 	Positivo
excelente 	Positivo
top 	Positivo
app preciso nao trava 	Positivo
bom 	Positivo
pude viajar problemas 	Positivo
pra mim melhor avisa todos radares nao precisa internet 	Positivo
cada dia melhor cada atualizacao fica melhor 	Positivo
ja usei 4 viagens funcionou legal 	Positivo
bom 	Positivo
agora adorando 	Positivo
bom util nao fico 	Positivo
app otimo otima interacao funciona jogo gps 	Positivo
merece 5 estrelas podem baixar vale pena desinstalado instaleio novamente agora descobri simular navegacao antes iniciar viagem 	Positivo
otimo tanto carro pe 	Positivo
app bom nordeste ajudou localizar hoteis reservado 	Positivo
parabens ate momento melhor apk 	Positivo
bom parabens 	Positivo
atual aparelho funcionamento perfeito 	Positivo
excelente usar estradas junto radardroid 	Positivo
otimas rotas acho opcao adicionar parada simplesmente fantastico 	Positivo
bom ajuda trânsito ja trabalho motorista recomendo todos 	Positivo
otimo maravilhoso 	Positivo
nao enfia furada favelas 	Positivo
informacoes uteis durante trajeto: transito tempos outras 	Positivo
ultima atualizacao visual ficou bom excelente aplicativo 	Positivo
otimo perfeito 	Positivo
sinal operadora eh perfeito 	Positivo
funciona bem 	Positivo
pra mim oculos nao saio casa super recomendavel melhor gps 	Positivo
bom aplicativo show 	Positivo
bom bom 	Positivo
dignos elogios 	Positivo
otimo app superou espectativa 	Positivo
cleomar melhor navegacao 	Positivo
bom ainda pode melhorar 	Positivo
aplicativo excelente 	Positivo
nota mil 	Positivo
parabens criadores 	Positivo
parabens mudancas 	Positivo
amo pq pode usar offline ajuda qnd 4g 	Positivo
bom itaquaquecetuba ubatuba 4:00h viagem direitinho otimo app 	Positivo
kra otimo 	Positivo
bom app parabens poderia ter funcao rotas caminhoes evitar q faca algum desvio dificil acesso subidas etc 	Positivo
gps bom ótimo app 	Positivo
inteligente excelente navegador comunidade inteligente 	Positivo
otimo pratico preciso 	Positivo
atende todas expectativas 	Positivo
bom 	Positivo
tipo app otimo app souber usar 	Positivo
otimo app identificar trajeto destinatario ajuda transitar seguranca principalmente alertando sobre divergencias transito importante aponta onde estao radares velocidade enche bolsos governos nao fazem nada pra melhorar condicoes condutores 	Positivo
bom app ajuda demais diaadia 	Positivo
melhor google maps seguintes razoes interface simples varios tipos alerta meio voz aviso excesso velocidade 	Positivo
bussola 10 	Positivo
bom util 	Positivo
ajuda 	Positivo
aplicativo bom 	Positivo
melhor ajuda motoristas internet 	Positivo
olha pessoal parabens realmente bom viajo sp realmente ajuda deixo off leva locais exato 	Positivo
otimo recomendo 	Positivo
perfeito estao parabens 	Positivo
app util pratico 	Positivo
facil usar 	Positivo
pessoas perdem tempo weize google maps informa bem melhor caminho transito real rodovias pistas serio problema destes aplicativos esquenta demais celular 	Positivo
offline correto aqui 	Positivo
bom bom 	Positivo
bom pra nao conhece nada cidade 	Positivo
bom aposentei velho gps ainda reduzi multas trânsito zero aplicativo indispensavel motoristas sao paulo 	Positivo
bom 	Positivo
bomsempre usei perfeito parabens criador nehuma multa ate hoje 	Positivo
ainda assim melhor gps podia maneirar propagandas 	Positivo
recomendo todos querem ocupar memoria celulares terem pessimos momentos vida claro recomendo principalmente querem perder tempo dinheiro 	Positivo
gostei poderia colocar pra funcionar cidades pequenas imagem lugar onde vc quer ir onde vc caso vc perca so olhar celular imagem destino vc acharia facilidade esso 	Positivo
sempre atualizacoes podem baixar 	Positivo
bom 	Positivo
excelente app pra ap 	Positivo
bem util ajuda sair trânsito varias ruas travada 	Positivo
surpreendi nao achei tao bom opiniao melhor waze 	Positivo
util perfeito uso muitoparabens realizadores 	Positivo
bom gps off line maravilhoso 	Positivo
adoro waze ajuda bastante tracar melhores rotas 	Positivo
bom 	Positivo
gps preferido 	Positivo
otimo 	Positivo
util 	Positivo
app fantastico 	Positivo
obrigado 	Positivo
hehe bom 	Positivo
fiz pequeno teste gosteiagora nao sei avisa radares amanha vou viajar ver melhoro estrelas 	Positivo
b bom 	Positivo
parabens precisando dessa navegacao offline 	Positivo
app bom 	Positivo
funciona 90% casos 	Positivo
top bom 	Positivo
show util 	Positivo
aplicativo maravilhoso 	Positivo
otimo aplicativo bom 	Positivo
ainda assim recomendo 	Positivo
esquecam outros 	Positivo
sempre bem ja testei portugal estados unidos utilizo diariamente paris 	Positivo
app bom 	Positivo
bom bom 	Positivo
satisfacao 	Positivo
melhor aplicativo existe taxistas 	Positivo
parabens todos contribuem 	Positivo
waze bom pra carros vcs deveriam desenvolver gps tambem caminhoes caretas pq lugar restricoes tomamos muitas falta sinalizacao waze truck obrigado 	Positivo
aplicativo ok 	Positivo
maravilhoso otimo app supri necessidades 	Positivo
quero parabenizar criadores 	Positivo
bom observacao fazer moro alcobaca bahia vou porto seguro so vez rota alcobaca prado itamaraju rota teixeira freitas sendo 150 km longe recomendo todos 	Positivo
bom 	Positivo
nao fico dia usa lo 	Positivo
bom vez perco todos pontos precisar formatar aparelho 	Positivo
assim otimo 	Positivo
otimo 	Positivo
ja usei antes app bom agora abaixei usar novamente 	Positivo
gostei 	Positivo
excelente app 	Positivo
otimo ja usava oi mapas 	Positivo
otimo 	Positivo
simplesmente funcional 	Positivo
app bom 	Positivo
achei excelente 	Positivo
Útil recomendo 	Positivo
bom sao paulo voltei cem problemas moca poderia informar velocidade radares 	Positivo
gente vcs melhoraram aplicativo estao parabens 	Positivo
top 	Positivo
parece q resolvido perfeito 	Positivo
otimo regular 	Positivo
mto bom 	Positivo
gostei fato poder continuar visualizando rota geral conexao cair 	Positivo
super preciso 	Positivo
bommas coisa q deve ter pra fica legal(colocar tambem icone moto usar gpsseria interessante) 	Positivo
consegui livrar transito economizar menos 30min paciencia mta gasolina 	Positivo
nao vivo você mao roda 	Positivo
mto util 	Positivo
excelente aplicativo achei preciso gps acho algumas ferramentas podem ser aperfeicoadas exemplo disponibilizacao acesso funcionamento aplicativo locais onde nao ha internet 	Positivo
otimo 	Positivo
melhor prograna uso todos dias 	Positivo
hallecs gostei 	Positivo
util escolher trajeto rapido 	Positivo
sempre utilizei levou destino qualquer problema 	Positivo
gostei bom app nunca deixou mao informa direito 	Positivo
bom 	Positivo
bom 	Positivo
melhor 	Positivo
maravilhoso 	Positivo
imbativel navegador 	Positivo
excelente 	Positivo
otimo ate hoje 	Positivo
aplicativo bom perfeito 	Positivo
adorei 	Positivo
cada vez passa aplicativo fica melhor sempre acrescentando novas funcoes 	Positivo
excelente 	Positivo
google completo todos sentidos 	Positivo
bom amavel 	Positivo
bom nota 10 	Positivo
otimo 	Positivo
bom util encontrar lugares nao sabe ir fugir engarrafamentos 	Positivo
lg gosteimuito exelente 	Positivo
simplesmente 5 estrelas 	Positivo
excelente parceiro trabalho 	Positivo
otimo recomendo 	Positivo
show 	Positivo
bom ajuda saber bom 	Positivo
gostei bom aplicativo 	Positivo
realmente util 	Positivo
norte funcionou perfeitamente ainda mostrou todos radares 	Positivo
mapaminhas direcoes otimo msm (y) merece 10 	Positivo
orientacao ajuda melhor caminho dar dicas precos gasolina conta 	Positivo
otimo gostaria desse pra baixar dados telemetria baixa strava 	Positivo
facil comecar usar muitas opcoes pra configurar voce gosta fucar previsoes tempo chegada destino sao boas atualizacao tempo real sas condicoes transito sao top 	Positivo
bom 	Positivo
procurando sinal gps dificuldades pra encontar sinal localizacao 	Neutra
poderia dar aviso sonoro ligarmos faróis próximo entrar rodovias 	Neutra
poderia ter opcao colocarmos trânsito livre atualizar demais usuarios 	Neutra
mim so falta alguns avisos radares alerta velocidade 	Neutra
sempre uso google maps falha vezes qdo uso rodovias onde trabalho 	Neutra
outras opcoes nao uso 	Neutra
desse ultima atualizacao dificilmente sintoniza rede funcionava bem antes 	Neutra
bom ja levou barranco 1 vez demora obter localizacao correta automóvel 	Neutra
rotas conhecidas gostaria poder optar rotas seguras tradicionais ficar entrando quebradas fazendo zigzag chegar destino 	Neutra
boa incluir opcao hud (heads up display) diretamente app 	Neutra
carro vai subir descer escadas ate escadas estreitas proprio carro 	Neutra
bom precisa atualizacao 	Neutra
aplicativo bom ultimamente deixando desejar 	Neutra
exemplo: aqui brasilia muitos ciclistas repente pudessem usar app meio dispositivos emitissem sinal carro alerta condutores ficarem atentos otimo 	Neutra
interessante corrigir detalhepois ta show bola 	Neutra
porque muitas vezes ate metade caminho sei ir nao consigo pesquisar antes estar local 	Neutra
aplicativo bom ate ultima atualizacao porem agora nao funciona navegacao fica parado vc faz rota nao acompanha nao fica triangulo navegacao 	Neutra
atualizacoes nada melhorar pra duas ruas tempo 	Neutra
fica tudo atras janelas 	Neutra
usei somente area urbana logo menos farei teste 	Neutra
nao localiza sinal rede/gps wifi 4g ligadinhos pleno funcionamento 	Neutra
anuncios nele hora iam aparecer graca relogio trabalha 	Neutra
suporte proprio novo ford ka pra deixar celular deitado 	Neutra
melhoria imagens tempo real cidade interior aparece apenas uns matos construcao representando anos atras atualmente aqui cidade predio etc maps nao carrega 	Neutra
falta haver opcao poder descarregar rota/mapa caso viagens paises nao ter trafego dados poder ter mapa/rota offline 	Neutra
bom vive travando uso conjunto uber vive travando 	Neutra
vcs pensar tambem caminhoneiros sobre altura pontes viadutos ruas nao permitido transito caminhoes ja pra nao ter dor cabeca pensar motoqueiros tambem ne apresentar tambem area risco roubos ok valeu 	Neutra
porem travou algumas vezes corrigindo detalhe completo 	Neutra
quero saber sobre questao ter velocimetro pardal 	Neutra
unico problema q acho q vao melhorar radares hora q passarem mandar alerta volte uns 1 km antes pq hora q vem alerta vc ja encima assim q fazer modificacao volto dar 5 estrelas 	Neutra
deveria ser possivel escolher rua indicar passa la 	Neutra
coisas ser objetiva simples 	Neutra
vcs podem melhorar qualidade recompensas entao facam 	Neutra
so deveria rever sinais gps rede q fica pedindo direto enquanto outros aplicativos funcionam normalmente restante tudo ok 	Neutra
publico bem primordial poder chegar destino forma segura rapida 	Neutra
bom porem vezes nao avisa radar 	Neutra
nao sei acontece waze aqui sao paulo 	Neutra
volta locucao luque dou 5 estrelas 	Neutra
menos bom 	Neutra
voces podiam fazem modo tela cheia pra evitar burnin modelos botao virtual 	Neutra
sempre destravo aparelho vejo ja rodando 2° plano 	Neutra
melhore ponto ganhara 5 estrelas 	Neutra
poderia melhorar visualizacao navegacao 	Neutra
sei foge proposito util tambem 	Neutra
marcio gostaria mostrasse radares tambem 	Neutra
sugestao melhoria poder gravar rota 	Neutra
uso viagens 	Neutra
aqui bh passando periodo chuvoso parar carro qualquer lugar pode ser sinonimo stress alagamentos 	Neutra
so acho deveria colocar alerta pra areas risco 	Neutra
bom porem ja entrei favela causa deus nao ouve nada comigo coloquei caminho enviou lugar comoletamente diferente rota 	Neutra
facam favor 	Neutra
so falta coisa 	Neutra
gosto opcao mapas offline imagem mapa horrivel voce zoo mapa fica todo borrado opcao quase inutil pra quer localizar internet 	Neutra
poderia melhorar modo recompensar contribuintes local guides 	Neutra
precisa sempre atualizando sistema fazer waze evite entrar favelas rio exemplo desativar ruas entra comunidades ok fica ai dica nao beram favelas 	Neutra
ja mandei inumeros feedbacks google nada 	Neutra
ja faz tempo mesma existe nao consta mapa 	Neutra
nao usar casa ponto partida 	Neutra
nao encontra alguns caminhos simples falta 1 mecanismo vc avisar transito naquele ponto acabou aviso interdicao via so esquina seguinte diante 	Neutra
nao tao preciso procurar endereco cidade 	Neutra
plataforma forte porem interesses 	Neutra
vezes escolhe rotas longas economizar alguns poucos minutos meio trajeto transito pode mudar tornar longo demorado 	Neutra
so caminhada trem metropolitano transporta cidade pra outra 	Neutra
so acho deveria ser atualizado dia transito noite outro 	Neutra
seta azul comeca andar pra tras 	Neutra
tanto aplicativo usando celular quanto conectado android auto 	Neutra
abandonei voltei maps 	Neutra
haver jeito nao esquentar tantonos ajudem 	Neutra
faco pra desinstalar app nao quer desinstalar 	Neutra
melhorando cada atualizacao bom comecou ficar ruim agora melhorando novo 	Neutra
quebra ganho vezes 	Neutra
cade opcao rota curta 	Neutra
querendo ver local iremos passar nao conhecemos nao 	Neutra
vi outros usuarios reclamando sobre informacoes erradas administradores app informando recepcao gps so todos entao 	Neutra
#voltaalessandra 	Neutra
vamos atualizar localizacoes ne maps 	Neutra
funcoes ja existem tripadvisor facebook 	Neutra
corrigirem subo nota 	Neutra
mostra radares acidentes precisos so ultimamente utilizando ir alguns locais nao preciso fez rota totalmente diferente algumas vezes mostra pouco confuso entrar determinadas ruas 	Neutra
entretanto acho funcao avisa presenca policiais deveria ser excluida pois favorece pessoas estao cnh problemas sequestradores ladroes etc 	Neutra
antes usava pra ir qualquer lugar 	Neutra
utilizo waze so vezes joga rotas proibido caminhao 	Neutra
vou comprar mapas america sul 	Neutra
agendaonde cadastraria carregariamos arquivo enderecos automaticamente lancaria tela ordem proximidades tracaria rota 	Neutra
google bem poderiam atualizar nomes ruas street view aqui 	Neutra
boa noite conta waze logado uns 3 anos mudei aparelho nao consegui recuperar conta bem avancado chegando ultimo nivel voces poderiam ajudar recuperar conta 	Neutra
realmente aplicativo uso qualquer lugar va so poderia avisar onde estao instalados radares acho completo 	Neutra
gostei opcao rotas alternativas "mais rapidas" tempo real m ainda melhorar 	Neutra
agora voces podem incrementa icone aba pra marcamos lugares ja visitamos linkar google trips assim vai virar vicio querer deixar tudo marcado visitar tudo mundo jogo fim 🤔 	Neutra
informa precisao 	Neutra
tipo clik tela superior inferior sumia deixando assim visao mapa rota livre 	Neutra
fazer 	Neutra
bom dia pra ter opcao desativar engarrafamentos muitas vezes ja fluindo bem trafico ter pessoas nao sabem distinguir transito sinal engarrafamento outra distancia nunca batem igual veiculo erros milimetros sao grande dirigi uber 	Neutra
sinal operadora celular ja trava vc vai seguir placas sinalizacao informando br nao vc ta rolado 	Neutra
otimo porem muitas pessoas relatam sempre manda rua rua paralela avenida principal podendo colocar ruas esburacadas etc 	Neutra
fazer zoom nomes ruas ficam pequenos nao percebe nome ruas preciso lupa utilizacao apeadada so funciona online 	Neutra
porem caminhoneiro gostaria opcao caminhao porque muitas ruas q manda subir entra q caminhao nao entra ai causa maior transtorno pudesse dar atencao pros caminhoneiro rodagem agradeceria obrigado 	Neutra
penso notificacoes fotos comentarios etc atrapalha navegacao verdadeira funcao desta app 	Neutra
esposa tambem acontesce outros celulares tambem 	Neutra
cuidado rotas indique menos tempo trajeto distancia pode fazer arrepender ter aceitado 	Neutra
nao uso fica atualizando toda hora queira precise ocupa espaco demais 	Neutra
arrumar dou estrelas 	Neutra
sugestao: criar funcionalidade tracar rotas evitando noias pedintes cidade sao paulo 	Neutra
nao melhores rotas 	Neutra
porem conectada ambos vezes ate wifi erro 	Neutra
observacao quanto localizacao radares br163 	Neutra
sugestao acho app poderiaassim aberto perguntar condutor carro passeio caminhao 	Neutra
alguma coisa possa fazer melhorar aguardo resposta 	Neutra
bom pena nao rotas off line pe transporte publico 	Neutra
funcionava perfeitamente apos algumas atualizacoes modo offline parou mostrar ruas avenidas aparece so gps antes perfeito 	Neutra
talvez ate ja nao consegui achar 	Neutra
precisava ter jeito gente escolher tamanho barra preta flecha nome rua fazer pesquisa 🔎 ruas cidade momento opcoes baixar mapas cidades 	Neutra
voce ate chega perder sobe ladeiras enormes vai caminho longo chega la 	Neutra
deveria fica encima tamanho bom visualizacao 	Neutra
otimo app questao aviso fiscalizacao velocidade uso wase porem gosto maps so falta questao 	Neutra
razoavel poderia ter 1) opcao navegar offline 2) podera ter opcao pra informar avisos offline online ai sim atualizaria rotas todos aviso pois brasil todo lugar rede pra si conectar 	Neutra
bom adicionar opcao desativar ativacao automatica layout modo noturno 	Neutra
bem vcs poderiam criar igone dentro app salvar rota vc faz carro rua ruanao ponto outro linha reta linha tempo ajudaria pessoal ussa trabalho maps 	Neutra
vou testar hoje nova atualizacao motociclistas 	Neutra
ser mantido usuarios ficamos sabendo hora congestionamento acidente exemplo 	Neutra
deveria perguntar queremos atualizar trajeto 	Neutra
resolver perda constante sinal 	Neutra
colocar opcao desativar modo noturno 	Neutra
bom nao dependesse internet 	Neutra
menos celular deitado acontece 	Neutra
bom eventualmente moca fica muda nao indica caminho verbalmente 	Neutra
nao pontuado ha tempos 	Neutra
software deveria gravar ocorrencia voltasse sinal atualizasse 	Neutra
ja desinstalei atualizacao agora voltou tudo normal 	Neutra
possivel implementarem funcao 	Neutra
otimo aplicativo gostaria saber proxima atualizacao vai ter escolher modo veiculo vc caso carro caminhao 	Neutra
rotas erradas mudancas bruscas meio rota cancelamento rota aviso indicacao caminhos perigosos funciona bem somente cidades estradas sinal celular sempre deixa mao vc pega caminho errado minimo paga pedagio 2x 	Negativo
apesar ter varias outras funcoes boa avisos radares blitz acender farois peca principal caminho faz muitas voltas sentido algum desinstalando prefiro google maps 	Negativo
volta nao achei boa nao 	Negativo
atualizacao recente parou dar imagem posicao primeira pessoa fica dificil localizar dirigir 	Negativo
so probleminha gente chega endereco corrento avancar uns 5 metros pra falar cheguei destino sendo ja numeracao certa 	Negativo
dificulta visualizacao mapa ta sempre escuro 	Negativo
diz teste 3 semanas nova atualizacao motociclistas rotas estao meio burras dando voltas desnecessarias nao ainda alertas ajudam motociclistas areia oleo pista chuva 	Negativo
ultima atualizacao acabou aplicativosou motorista uber waze nao consegue instalar linguagem fechavou ter q trabalhar mapsarrumem favor 	Negativo
so nao dou cinco estrelas nao funciona bem offline here drive 	Negativo
br vai pra rio ostras nao conhece falar radar nao avisa avisa devia ser aviso sonoros alem aviso visual 	Negativo
navegando ponta cabeca 	Negativo
ruim pessimo horrivel horroroso 	Negativo
quase morri gps viagem inves mandar ir estrada guiou "atalho" meio area risco trafico drogas 	Negativo
trabalho app dias ruim nao sair ponto azul seta demora aparecerse passa ruim arvores app fala sinalantes dessas atualizado app otimo agora ruim fica sinal sinal normalmente favor tenta fazer atualizacao melhor 	Negativo
navegacao lugares desconhecidos inferior google maps 	Negativo
nada sumiu seta q indica direcao nao segue trajeto so fica parado pra q ficar inventando monte bosta app 	Negativo
dando diferenca tempo real atrasado pouco localizacao voz proprio carrinho 	Negativo
modo paisagem todo bugado 	Negativo
ja aconteceu comigo florianopolis bem assustador 	Negativo
pena 	Negativo
consome bateria dados desejar 	Negativo
usar so atrasou percurso 	Negativo
gostava mto utilizar maps porem qdo troquei celular moto g play comecou travar acabar atrapalhando trajetos 	Negativo
poderia ser melhor 	Negativo
so nessa ultima atualizacao deixou grande falha questao orientacao voz nao funciona favor equipe arrumem nao permanece bug resolver ai sim darei 5 estrelas 	Negativo
opiniao demora mostrar direcao tb faz muitas voltas caso erros trajetos ex: n pede retornar imediato fazendo quer vamos apenas frente inves voltarmos 	Negativo
nao outro gps salvo smartphone nao chegado 	Negativo
nao instalem opcao evitar pedagio nao funciona pois agora pagar 2 pedagio 	Negativo
porem goiania semana acho aplicativo ressaca fim ano ia endereco certo mandava voltar tras bom queria vir embora uberlandia pedindo ir outra cidade 	Negativo
nao funciona gps aparece acordo andamos fica so porcaria mapa olhando cima ponto lixo 	Negativo
ajuda aqui cidade bom ajudado bastante pena nao of line nao mostra radares vias atrapalha 	Negativo
pois dirijo apenas madrugada onde nao transito rota rapida nao sendo rapida dando muita volta necessidade precisa corrigir rapido possivel 	Negativo
baixei tom tom mapas sim bom ainda rua engarrafamento faz desvio rota 	Negativo
pois colocam gente centros urbanos proibido tipo veiculo 	Negativo
deixa desejar termos fluidez claro depende configuracao celular 	Negativo
tb nao possivel postar ocorrencias trajeto 	Negativo
precisao ainda nao boa 	Negativo
ficado cada vez pior acho falta concorrencia 	Negativo
horrivel trava tempo todo 	Negativo
nao atualiza linhas onibus opcoes atuais 	Negativo
pesa memoria lento 	Negativo
consome muita bateria 	Negativo
ja vi tanta reclamacao ainda nada desenvolvedores resposta pra gente axo q nao taum ai usuario 	Negativo
porem dependencia conexao internet deixa desejar trajetos rodoviarios 	Negativo
horrivel endereco aparece errado 	Negativo
gostaria ver cidade la bahia nao aparece atualmente 	Negativo
alem disso qdo uso celular horizontal caixa dialogo ocupa 1/4 tela dificulta ver mapa 	Negativo
atencao devops: app acabando bateria celular 1h msm utilizando carregador veicular 	Negativo
cai sinal internet acaba waze 	Negativo
joga favelas 	Negativo
deveriam dar ouvidos fizessem alguma mudanca vez acabam descredito ate desuso app 	Negativo
ja otima 	Negativo
apos atualizacao app nao vem funcionando bem desinstalar instalar novamente ver funciona caso contrario usar outro app 	Negativo
sempre localiza errado 	Negativo
voces atualizam tanto estao estragando aplicativoagora ja faz uns tres meses fica aparecendo mensagem gps sinal aqui pinhais parana dificultando chegarmos lugaresnao problema internet favor tentem concertar 	Negativo
simplesmente nao quero nao preciso 	Negativo
aff Última atualizacao nao instala nunca 	Negativo
nao funcionandi cono antes atrasa nao posicao correta todos lugares 	Negativo
trava demais 	Negativo
espero corrijam problema senao fica inviavel utilizar servico pena 	Negativo
unico problema poder avisar policia favorece escapando dificultando trabalho favorecendo criminalidade 	Negativo
lixo 	Negativo
app nao funcionando 	Negativo
tempo inteiro dando erro 	Negativo
waze funciona bem melhor 	Negativo
caso você erre rota principalmente lugares remotos onde vc nao conhece nao calcula novo trajeto conta internet 	Negativo
nao acerta horario onibus aqui natalrn 	Negativo
contar proprio google maps piorou 	Negativo
entretanto ultimamente indicando caminhos curtos porem demorados porque desvia vias principais avenidas 	Negativo
nao sei ja sao muitos usuarios impressao waze so servindo enderecos nao conheco pq fugir transito 👎 	Negativo
dps atualizacao app fecha sozinho fica travando toda hora trabalho mobilidade urbana antes waze melhor duvida agora so usando maps 	Negativo
agora sai rota sempre fica recalculando direto ja fez cair lugares perigosos 2x 	Negativo
pessimo ja troquei 2 x celular (moto g 3 samsung a3) continua procurando rede 	Negativo
frita motog 2 alem celular esquentar ficou botoes ruins postar problemas 	Negativo
aplicativo varios problemas toda vez voce fecha aplicativo perde toda configuracao inclusive dados usuario 	Negativo
ruim ruim 	Negativo
falta urgente disponibilizacao mapas navegacao offline sao paulo visto nao sempre acesso internet movel (pessima qualidade sinal operadoras celular brasileiras) ta hora maps absorver funcoes waze (que adquirido google) informar radares acidentes etc 	Negativo
vezes google mapas ajuda melhor trajeto sp bairro morumbi waze jogou dentro favela paraisopolis cortar caminhoqndo vi ja nao jeito sair 	Negativo
atrapalha experiencia usuario 	Negativo
concorrencia qualidade acaba acontecendo waze 	Negativo
	Negativo
infelizmente nao igual navegador precisa deixar identico 	Negativo
reseta volta ingles 	Negativo
pra mim tanto android ios delay posicao fisica quanto mostrada aplicativo ruas proximas torna impossivel usar 	Negativo
lento vou fazer entregas derruba demora pra mostrar direcao pra q lado ir 😐 trava muitoo lentoo 	Negativo
diz q lugar nada ver onde realmente 	Negativo
contudo eventualmente travada aplicativo momentos voce perdido justamente precisando funcionamento pleno 	Negativo
porem ainda fica localizando locais impossiveis 	Negativo
show trânsito ainda precisa melhorar pois ocasioes coloca lugares trânsito pior define pessimas rotas 	Negativo
foda ruim galera aplicativo ruim fala po re oidicupa xega 	Negativo
ate desgosto ter app celular melhorem favor 	Negativo
precisa melhorar ficar ruim 	Negativo
app ja mandou pra dentro favelas 	Negativo
desisto realmente problema aplicativo 	Negativo
estao destruindo aplicativo 	Negativo
duas vezes aparelho desligado causa super aquecimento causado app oh pessoal waze deveria estar atento 	Negativo
muitas informacoes desnecessarias tela todo minuto ficar tirando mao volante pra apagar informacoes travando perdendo sinal gps ta pior piores ja melhor todos contrataram nerd pra estragar aplicativo 	Negativo
pessimo aplicativo 	Negativo
tambem bolinha hora iniciar dirigir nao ajuda nada pois gente nao sabe rumo gente deve iniciar 	Negativo
pena perdi voz luciana comprei moto g2 agora desativado 	Negativo
chato trava fecha todas vezes coloco rota 	Negativo
rotas longas vezes necessidade retorno nao fica procurando rede internet pleno funcionamento 	Negativo
burro aplicativo 	Negativo
ia fazer rota mapa nao ia pra frente 	Negativo
⭐⭐⭐ rua quintino bocaiuva setorcampinas goiânia goias final desta rua encontro av castelo branco contra nao ja gps rota mao certa multado la falta vcs atualizar rua 	Negativo
vou tentar atualizacao pois atualizacoes anteriores bugs pois colocavam m ruas saida tempo chegada destino dando muitas discrepancias 	Negativo
so informacao area risco nao informacao suficiente 	Negativo
vou desinstalar 	Negativo
vezes nao captura sinal gps faz abra mapsocorre normalmente ligo desligo gps celular visando economia bateria 	Negativo
ruin rua prossimo casa estao embaralhadas 	Negativo
app parandoquando chego determinado lugar pede pra tirar foto funcionar 	Negativo
apenas ruas mapa sao pouco quase mesma cor plano fundo restante mapa 	Negativo
demora nao encontra resolve problema 	Negativo
perde sinal internet apos reestabelecer nao conecta preciso reiniciar aplicativo 	Negativo
lamentavel 	Negativo
ficou bolinha azul pessimo voltem antes agora deixo definitivamente usar 	Negativo
porem devera calcular nova rota nao informar pra retornar problema cidade vinhedo ate cidade campinas onde durante percurso vez continuar direto rod dom pedro i enviou pra cidade valinhos retornar pra mesma 	Negativo
nao sei ta acontecendo app ultimamente anda travando gps nao atualizado nao dando caminho correto ruas saidas obras caminho volta pra tras atualizar gps caminho estavamos favor revolver anda mim prejudicando 	Negativo
"tarja preta" indicativa proximas conversoes terrivel 	Negativo
varias falhas obtencao gps ficando lento 	Negativo
dificulta visualizacao transito 	Negativo
poderia nao ocupar grande espaco armazenamento rotas nao facilitam planejamento viagem relacao percursos linhas horarios mostrados transporte publicos 	Negativo
nao interessante nao dar pra mudar rota adicionar paradas evitar alguma passagem alem ter interface basica menu suporte nao funciona 	Negativo
dirigindo visualizacao mapa cima dificulta entendimento 	Negativo
falhoerra acerta endereco 	Negativo
nao gostei tipo baixa mapa pega area ficou bem ruim assim vou pra outro aplicativo nao serve pra mim 	Negativo
horrivel 	Negativo
falta alguns ajustes tipo locutor robotico 	Negativo
odieiiiii 	Negativo
waze hora falha aplicativo gps bom ser usado hora falha demora reiniciar fica rede direto gente trabalha aplicativo motorista muitos estao fazendo reclamacao estao deixando usar waze usar maps demora demais reiniciar localizar ta demorando ver voces conseguem dar melhorada nele 	Negativo
quase morrerem 	Negativo
enquanto vou google maps 	Negativo
antes bom 	Negativo
pena rede dados troca 4g 3g 2g fica perdido procurando rede 	Negativo
bosta 	Negativo
completamente errado caminhos rotas nao dao lugar nenhum 	Negativo
aplicativo comecando dar erros fica ruim condutor assim nao nao internet dando uns atrasos localizacao 	Negativo
hj dia perdeu qualidade 	Negativo
vezes traca uns caminhos ziguezague deixa puto 	Negativo
informacao poderia ter salvado vidas passado pode salvar vidas futuro 	Negativo
entro configuracoes colocar voz mulher google auxiliar trajetos nao fala nada mapa buga fala ta rua verdade voce outra atualizei virou movuca 👎👎👎👎 	Negativo
apenas gps nada incrivel brasileiro nao perde mania estragar funcionando so ser vendido simplesmente acabo otimo agr 🖓pelo menos servido orientacao ai vc vê acontecendo sevira maluco menos mal 	Negativo
só funcionouuma semana nao abriu 	Negativo
coisas ser melhorado 	Negativo
ultimamente instavel 	Negativo
nova atualizacao horrivel 	Negativo
baloes nomes ruas ainda piscam pouco lugares diferentes tela movimento atrapalhando atencao estrada 	Negativo
precisa atualizar mapa urgente transito mudou varias cidades mapa nao niteroi gps manda entrar onde nao rua construiram mergulhao gps fica indicando rua qua nao existe 	Negativo
precisando atualizar aparecendo rotas inexistentes linja tempo aponta lugares voce nao 	Negativo
encontra posicao porem traco destino pressiono "ir" simplesmente diz ter perdido sinal gps 	Negativo
perdeu estrela porque colocou rota bizarra 	Negativo
ponto azul vezes mexe 	Negativo
precisa deixa maodiz sinal internet mentira desastre horrivel nao recomendo 	Negativo
acho ruim vc recebe localizacao aplicativo pede 3 confirmacoes poder comecar rodar 	Negativo
conseguiram piorar ja ruim 	Negativo
ultima atualizacao usar app transportes nao funciona direito vc coloca navegacao nao vai agora tela navegacao direto passa monte tela estacionamento antes amor deus arrumem 	Negativo
ja melhor hj mim piorpor ser online deveria ser preciso porem sinal celular perfeito gps perde sinalacusa outro lugar nada vermuita atualizacao desnecessarios estragou app 	Negativo
acho confuso coloco destino varias opcoes entao verifico quero voltar ver outros trajetos nao consigo 	Negativo
so nao navegando aplicativo enquanto ouvir musica porque tende desligar mp3 gostaria saber porque nao posso utilizar aplicativo ja telefone multifuncional 	Negativo
apos ultima atualizacao continua pessimo 	Negativo
so nao pode deixar gente contra mao 	Negativo
simplesmente horrivel demora eternidade calcular rota deveria ter opcao usuario escolher quer trabalhar modo noturno modo noturno horrivel dirigir deveria ter opcao desabilitar 	Negativo
nao funciona 	Negativo
trava varias vezes nao causa internete 	Negativo
ruim lento confuso mapa nao rotaciona cursor fica "perdido" indica caminho errado muitas vezes 	Negativo
acabei perder prova concurso fornecerem endereco errado 	Negativo
1toda hora aparece mensagem aplicativo parou responder 2 manda virar locais proibidos (o nao acontece waze) 	Negativo
app ainda escolhe radares avisar sonoramente trava bastante ads sao invasivos 	Negativo
po fica desejar parece caras estao preguica passar algumas ruas 	Negativo
ultima atualizacao ficou ruim demora pra atualizar carrinho tela uber perdi duas corridas causa desse erro 	Negativo
problema passar outro caminho gps nao atualiza rota automaticamente fica mandando voltar tempo todo desligar 	Negativo
errou caminho 	Negativo
aplicativo otimo ate uns 6 meses atras porem troquei celular gram prime achei defeito agora galaxy s7 continua horrivel ainda agora so pra visualizar cima 	Negativo
semana passada ca ficado estranho aparecido procurando sinal gps achei podia ser telefone nao outros gps instalado estao funcionando normalmente preferido waze probleminha usado so vezes espero resolvam rapido possivel 	Negativo
semana duas situacoes desagradaveis relacao trajeto sugerido app 	Negativo
