bom nota 10 recomendadissimo 	Positivo
aplicativo ok 	Positivo
bom estao parabens ja baixado app desistalei epoca falta espaco instalar novo so outra cor icone dificil pra mim achar valeu apena procura bom 	Positivo
bem util ajuda sair tr芒nsito varias ruas travada 	Positivo
recomendo todos 	Positivo
adoro wase 	Positivo
bom melhor 	Positivo
pessoal nao ficar comentado app nao merece todos elogiosta parabens app bom msm 	Positivo
bom aconselho 	Positivo
otimizado ficou legal versao "maps" aibda melhorar 	Positivo
bom 	Positivo
app bom nordeste ajudou localizar hoteis reservado 	Positivo
quero parabenizar criadores 	Positivo
guia preferido utilizo sempre 贸timo todos aspectos 	Positivo
bom 	Positivo
aplicativo bom 	Positivo
bom 	Positivo
bom excelente 	Positivo
melhor conheco precisa melhorartem alguns problemas ca n贸s nao nenhum tao completo 	Positivo
bom parabens 	Positivo
pra mim melhor avisa todos radares nao precisa internet 	Positivo
essencial parabens equipe waze 	Positivo
melhor parte deste app mapa offline pra usar gpsusei ontem incrivel 	Positivo
adorei 	Positivo
aplicativo eficiente 	Positivo
waze melhor aplicativo mundo ganha pao melhor aplicativo transito mundo 	Positivo
nao vou ate padaria waze ligado 	Positivo
bom es gps 	Positivo
salvacao capital 	Positivo
ate momento sido bom aplicativo 	Positivo
melhor nao gasta quase nada franquia 	Positivo
aconselho pessoas baixarem 	Positivo
ate agora nao deixou mao bom 	Positivo
bom 	Positivo
demais recursos sao excelentes 	Positivo
bom demais bem gostei 	Positivo
excelente app pra ap 	Positivo
bom 	Positivo
bom aplicativo 	Positivo
bom  	Positivo
bom util nao fico 	Positivo
aplicativo util 	Positivo
otimo aplicativo interessante opcao pessoa chegar localizacao sugerir quero registrar google agenda 	Positivo
show 	Positivo
otimo 	Positivo
maravilhoso 	Positivo
otimo ate entao nao conheco nenhum melhor 	Positivo
excelente bom funciona off line 	Positivo
show preciso 	Positivo
melhor gps atual 	Positivo
melhor navegador mundo nao vai qualquer lugar perfeito 	Positivo
gps otimo 	Positivo
bom maravilhosos aqui sao paulo capital interior melhorada hoje rua quer nao mao dupla hoje contra mao cidade muda transito voce nao acompanhar mudanca tempo real 	Positivo
bom 	Positivo
bom util 	Positivo
otimo app 	Positivo
mim otimo #curto bastante so detalhe vezes parados acha andando dai pede pra colocar passageiro 	Positivo
parabens desenvolvedores 	Positivo
lenovo c2 bom tanto prova rapido eficaz pr贸prio computador menos celular nao tava bugs etc 	Positivo
waze 贸timo aplicativo descricao taxista gostei nova versao 	Positivo
melhor 	Positivo
otimo bom 	Positivo
offline correto aqui 	Positivo
compra google agora perfeito atualizado agora ficou fodastico 	Positivo
melhor impossivel 	Positivo
bom 	Positivo
app utilidade publica n 1 imprescindivel 	Positivo
hoje considero uso waze indispensavel qualidade vida ja nao perdemos tanto tempo transito 	Positivo
bom excelente 	Positivo
amei app d+ app maravilhoso vc nao baixou baixe certeza vc vai 10 estrelas dou nota 10(dez) 	Positivo
otimo gostaria desse pra baixar dados telemetria baixa strava 	Positivo
atende todas expectativas 	Positivo
melhor google maps seguintes razoes interface simples varios tipos alerta meio voz aviso excesso velocidade 	Positivo
bom adorei 	Positivo
excelente 	Positivo
excelente deveria ter opcao excluir fotos conteudos irrelevantes pois clientes estao postando fotos produtos cadastro empresas 	Positivo
perfeito estao parabens 	Positivo
app otimo otima interacao funciona jogo gps 	Positivo
otimo 	Positivo
fiz viagem 720 km sempre avisou radares certinhos 	Positivo
otimo 	Positivo
familia amamos app 	Positivo
norte funcionou perfeitamente ainda mostrou todos radares 	Positivo
excelente 	Positivo
bom 	Positivo
bom 	Positivo
aplicativo otimo 	Positivo
bom 	Positivo
sempre bem ja testei portugal estados unidos utilizo diariamente paris 	Positivo
bom bom 	Positivo
bom s贸 q ter cuidado porque nao faz diferenca lugares risco nao risco 	Positivo
excelente show bola 	Positivo
ate agora achei bom 	Positivo
gostei cumpre objetivos bom indicasse proximidade radares 	Positivo
dom pesca utiliza waze uso app organizar viagens pesca lazer 	Positivo
app bem util 	Positivo
otima ideia perfeito 	Positivo
app bom 	Positivo
sim bom 	Positivo
recebi muitos bons olhos feedback sobre navegacao surge imediatamente apos termino sobre grau satisfacao bem acertividade mesma 	Positivo
melhor melhor incomparavel 	Positivo
restante parece estar tranquilo 	Positivo
otimo app alem funcionar internet aplicativo conectado rede informa transito otimo nao 3g pois posso abrilo casa ver transito ja calcular melhor rota nota 10 desenvolvedores 	Positivo
aplicativo otimo pois faz varios avisos durante transito 	Positivo
otimo tanto carro pe 	Positivo
satisfeito rotas opcoes 	Positivo
recomendo todos querem ocupar memoria celulares terem pessimos momentos vida claro recomendo principalmente querem perder tempo dinheiro 	Positivo
nota mil 	Positivo
gostei onde passei mostra radares caminho bem certinho 	Positivo
app melhora cada vez 	Positivo
app bom 	Positivo
otimo ja usava oi mapas 	Positivo
10 vale pena 	Positivo
top bom 	Positivo
ajudado bastante 	Positivo
adorei 	Positivo
otimo aplicativo perfeito funciona bem 	Positivo
informacoes uteis durante trajeto: transito tempos outras 	Positivo
sergio menezes ola bom 	Positivo
timo bom adorei 	Positivo
bom bom 	Positivo
olha waze pra min bom 	Positivo
otimo 	Positivo
gostei 	Positivo
bom 	Positivo
melhor 	Positivo
colocar recurso app sera melhor todos 	Positivo
melhor ajuda motoristas internet 	Positivo
bom aplicativo 	Positivo
avaliacao nota dez 	Positivo
top confiavel 	Positivo
simplesmente cumpre promete util 	Positivo
valeu 	Positivo
radar 500m cinquenta klm horasfoi recomendar amigos 	Positivo
bom 	Positivo
excelente 	Positivo
eh mto bom moro grande florianopolis dois anos ainda nao aparece loteamento google maos ja atualizar dou 5 estrelas pq app eh otimo 	Positivo
otimo 	Positivo
realmente util 	Positivo
esquecam outros 	Positivo
gostei bastante vamo ver funciona 	Positivo
app otimo principalmente off line 	Positivo
bom 	Positivo
bom 	Positivo
facilidade indicar rua dizer nome ajuda cidades nao conhecemos 	Positivo
otimo pratico preciso 	Positivo
possibilidade salvar mapas off line aplicativo ficou show 	Positivo
nunca deixou mao 	Positivo
nao enfia furada favelas 	Positivo
app preciso nao trava 	Positivo
usamos app bom avisa ha foto sensor 	Positivo
melhor mundo ate agora 	Positivo
indispensavel uso waze trajetos conhecidos ja pode haver manifestacoes engarrafamentos etc 	Positivo
bom 	Positivo
otimo uso todos dias 	Positivo
bom 	Positivo
app cada vez melhor 	Positivo
ja melhor 	Positivo
toda certeza melhor aplicativo gps sistema offline atualidade sistema navegacao preciso opcoes escolher melhor rota avisos radares visiveis nao visiveis pista orientacao visual limpa legivel opcoes pontos turisticos etc simplesmente otimo trabalho continuem assim usuarios possamos indicar fazer comunidade crescer cada vez 	Positivo
geral ajuda bastante uso bom senso escolha opcao trajeto 	Positivo
restante otimo aplicativo 	Positivo
gostei bom 	Positivo
facil usar 	Positivo
util 	Positivo
recomendo todos 	Positivo
samsung galaxy note4 bom pratico facil usar recomendo 	Positivo
bom amei 	Positivo
programa maps si bom ja funcao gps acho bem fraca principais funcoes falta sao mostrar radares fixos mostrar velocidade permitida rua trafegando funcao offline deveria ser estado nao area agora 	Positivo
bom recomendo 	Positivo
otimo app ajuda chegar locais nao conheco adorei 	Positivo
tony top uso faco entregas lanche nao sei pesquiso map rapido pratico 	Positivo
otimas rotas acho opcao adicionar parada simplesmente fantastico 	Positivo
aplicativo show bola ant么nio jacinto silva filho 	Positivo
bom so faltando rotas alternativas 	Positivo
aplicativo bom 	Positivo
amo ap anem ter gps fala valores taxi uber 99 faz calcula kilometragem distancia ate destino explica faz tragetoria conducao ate destino bociclata ape procura todos restaurantes aria lazer etc tudo perto voce d+ ap 	Positivo
t么 gostando bastante app vcs pediram abrir app ja soubesse caminho avisaria radares etc 	Positivo
aplicativo sempre auxilia bemum problemas verifiquei duas ultimas viagens fiz questao radares nao estao atualizados alguns pontos rodovia tamoios anhanguera 	Positivo
bom util 	Positivo
bom 	Positivo
bom 	Positivo
otimo app 	Positivo
usei alguns lugares off deu certo logico lugar q so online muitos lugares tracou rota offline mui bom 	Positivo
aplicativo excelente 	Positivo
bom excelente 	Positivo
voc锚 vira rua errada faz outro trajeto voc锚 voltar direcao certa 	Positivo
bom inteligente didatico 	Positivo
gps incrivel 	Positivo
bom 	Positivo
excelente app pra ap 	Positivo
ainda continua sendo bom 	Positivo
aplicativo fantastico permite inclusive fazer simulacao rota nao surpresas caminho 	Positivo
melhor aplicativo existe taxistas 	Positivo
tirando top 	Positivo
bom 	Positivo
agora adorando 	Positivo
uso horas todo dia 	Positivo
bom 	Positivo
bom uso sempre 	Positivo
amo pq pode usar offline ajuda qnd 4g 	Positivo
tudo google faz bom nada reclamar 	Positivo
parabens desenvolvedor 	Positivo
otimo 	Positivo
app melhorou desde algumas versoes anteriores 	Positivo
otima navegacao 	Positivo
cada vez melhor 	Positivo
so funcionar off line ta excelente 	Positivo
gostei poderia colocar pra funcionar cidades pequenas imagem lugar onde vc quer ir onde vc caso vc perca so olhar celular imagem destino vc acharia facilidade esso 	Positivo
bom excelente aplicativo nao pesa cel deixa localizacao exata 	Positivo
otimo aplicativo leva enderecos erros contar avisa onde radares 	Positivo
menos aqui metropole funciona bem feito bom uso 	Positivo
recomento todos 	Positivo
otimo 	Positivo
bom 	Positivo
melhor app offline ja usei 	Positivo
aplicativo bom recomendo 	Positivo
aplicativo bom 	Positivo
otimo 	Positivo
maravilhoso simplesmente indispensavel todas horas 	Positivo
	Positivo
precisava ter jeito gente escolher tamanho barra preta flecha nome rua fazer pesquisa  ruas cidade momento opcoes baixar mapas cidades 	Neutra
ainda nao sei funciona dados movel endereco correto ate agora 	Neutra
so acho deveria ser atualizado dia transito noite outro 	Neutra
"o futuro" pede maior interatividade ordens voz exemplo "ok google compartilhar rota com" recomendo google mapas 	Neutra
modo paisagem voce recalcula rota clica botao centralizar rua seguindo fica centralizada nao levemente direita mapa escondendo rota precisa seguir atras painel informacoes 	Neutra
nao uso fica atualizando toda hora queira precise ocupa espaco demais 	Neutra
lotou propaganda agora hein 	Neutra
poderia opcao offline nao ter ser atualizada cada 30 dias 	Neutra
ligo modo carro app so exibe visao superior mapa nao serve pra nada 	Neutra
esperando atualizacao 	Neutra
app sugeriu trajeto cheguei ponto embarque balsa mesma ja nao horario funcionamento 	Neutra
pq todo mundo usa pra sair engarrafamentomuitos usam pra saber caminho 	Neutra
colocar radares velocimetro app azul claro google maps vira melhor app navegacao todos 	Neutra
querendo ver local iremos passar nao conhecemos nao 	Neutra
prefeitura mapeadas areas risco favor incorporem informacao aplicativo 	Neutra
realmente aplicativo uso qualquer lugar va so poderia avisar onde estao instalados radares acho completo 	Neutra
transporte usado zona oeste brt rio nao aparece rota mapas 	Neutra
legal ja vi estao dando atencao pessoas andam moto ainda vou aguardar lancarem modo moto previsao tempo rota selecionada tambem deveria ter modo economia onde apaga tela celular fica navegacao so voz nao ter ficar desviando olhar pista ja voz maps muuuuito explicativa 	Neutra
coloquem opcao montar etinerarios diversos pontos parada melhor rota passagens pontos ia ser perfeito profissionais 	Neutra
poderia ter antecipacao faixa via rapida marginal app so mostra manter direcao 	Neutra
corrigir ai vai pro 10 	Neutra
ajuda ruas nao funciona 	Neutra
ap贸s atualizacao android 6 parou funcionar s贸 reinstalar voltou normal 	Neutra
sempre usei gps entregas porem alguns enderecos nao estao certos tento entrar contato suporte nao consigo email suporte consta incorreto aguardo respostas equipe gps brasil 	Neutra
corrijam favor voltem ser melhor app 	Neutra
tomem cuidado app bom muitas vezes faz venhamos fazer zig zag causa 1 minuto menos 	Neutra
tbm ruas onde nao condicoes trafego pesado 	Neutra
vcs deveriam fazerem atualizacao usarmos google maps ter escolha tipo automovel dirijindo motorista ambulancia ambulancia pode anda corredor onibus ai nao sabemos caminho ensina maior volta chega lugar sendo corredor faixa onibus tudo facil rapido 	Neutra
legal mostrase estradas nao assaltadas cores notificacao 	Neutra
usando espelhamento android auto mylink carro (multimidia original chevrolet) ligar farois mapa fica tema noturno 	Neutra
bom atualizar ser rapido 	Neutra
alguma coisa possa fazer melhorar aguardo resposta 	Neutra
nao sei acontece waze aqui sao paulo 	Neutra
plataforma forte porem interesses 	Neutra
nao falo so mim falo todos local guides contribuem maps ficar melhor receber fato merecem 	Neutra
nao conseguindo pedi so fica dando tente novamente tarde 	Neutra
informa nao rede 	Neutra
poderia ter configuracao caminhao area trafego restrito altura viadutos limites velocidade veiculos pesados 	Neutra
bom pena nao rotas off line pe transporte publico 	Neutra
menos celular deitado acontece 	Neutra
pessoa sempre ter registro viagens diarias 	Neutra
deveria permitir baixar trajeto navegar offline 	Neutra
bom dia pra ter opcao desativar engarrafamentos muitas vezes ja fluindo bem trafico ter pessoas nao sabem distinguir transito sinal engarrafamento outra distancia nunca batem igual veiculo erros milimetros sao grande dirigi uber 	Neutra
nao funcao ativa rede dados 	Neutra
amo app sempre ajuda vezes preciso consultar caminho sei ir ate determinado local nao consigo pesquisar partir desse local ate destino final tipo nao tal local tal lugar ajudava 	Neutra
fica so calculando transito nao podemos perder tempo 	Neutra
favor ajustar isso 	Neutra
perdi compromisso rodei 600km atoa 	Neutra
nao usar casa ponto partida 	Neutra
atualizacao necessaria informando caminho incorreto 	Neutra
mes q mandei correcao ainda nada 	Neutra
propria voz gps (um aplicativo externo pra fazer caso) ganhar pontos ajudar melhorar mapa trocar itens 	Neutra
nao pra ter opcoes personalizadas rotas usuario 	Neutra
app eh bom porem precisa melhorar inicio navegacao lento atualizar nova rota circulo inicial atrapalha 	Neutra
poderia dispor mapa offline 	Neutra
deveria perguntar queremos atualizar trajeto 	Neutra
muitas vezes levar areas perigosas 	Neutra
vcs pensar tambem caminhoneiros sobre altura pontes viadutos ruas nao permitido transito caminhoes ja pra nao ter dor cabeca pensar motoqueiros tambem ne apresentar tambem area risco roubos ok valeu 	Neutra
ultima atualizacao nao mostra caminhos modo horizontal (somente cima baixo) 	Neutra
poderia melhorar 	Neutra
titulo exemplo criacao pasta "restaurantes" onde possivel guardar nessa mesma pasta localizacoes restaurantes interesse 	Neutra
seta navegacao deve aparecer desde inicio navegacao 	Neutra
otimo app sugestao: chegar pr贸ximo radar poderia haver alerta eficiente 	Neutra
acho sugestoes rota devem ser conciliadas horarios funcionamento balsas exemplo 	Neutra
deveria atualizar ruascasas etc 	Neutra
opcao usar smartphone dash can filmar trajeto possivel duas cameras smartphones boa pot锚ncia hardware 	Neutra
neste dispositivo ponto azul mapa certo tempo uso comecou mover automaticamente saltando cada casa 	Neutra
publico bem primordial poder chegar destino forma segura rapida 	Neutra
s贸 falta atualizar 	Neutra
ribeirao preto radar nao informado gps 	Neutra
vou comprar mapas america sul 	Neutra
usuario safado inserindo informacao errada proposito 	Neutra
pergunta nao resposta kkkkkk 	Neutra
nao localiza sinal rede/gps wifi 4g ligadinhos pleno funcionamento 	Neutra
algo apps corridas uber cabify 99 deveriam urgentemente adicionar apps tambem 	Neutra
elogio correcao indispensavel liguei carro liguei waze area sombra transmissao dados nao consigo notificar deixa marcar ponto faze lo rede dados restabelece 	Neutra
deveria permitir ditar regras percurso rapido pois vezes pais rapido nao economico 	Neutra
favor revejam erro 	Neutra
sugestao acho app poderiaassim aberto perguntar condutor carro passeio caminhao 	Neutra
avisa aproximacao radares fixos velocidade permitida 	Neutra
excelente aplicativo deveria ser completo exemplo mostrar radar certeza voces tecnologia suficiente acrescentar 	Neutra
ultimas atualizacoes velocidade nao batendo velocimetro carro ja testei outro carro tbm nao internet porque passa radar marca velocidade bate carro waze uns 5 4 km baixo 	Neutra
inverte numeracao ruas 	Neutra
vou testar hoje nova atualizacao motociclistas 	Neutra
bom porem nao pra baixar mapas cartao mem贸ria botei tambem opcao baixar mapa inteiro brasil 	Neutra
sugestoes: permitir download rota offline 	Neutra
bom precisa atualizacao 	Neutra
programadores fizeram essaultimanova versao 	Neutra
falta relogio velocida (velocimetro ficaria ainda melhor) ai estaria completo app ta perdendo pro waze 	Neutra
pedagios deveria somar pedagios trajeto tambem perguntar queremos atualizar trajeto pois momento entra atualizar fica sinal operadora perdemos trajeto ja pre determinado 	Neutra
favor corrigir breve possivel 	Neutra
so acho deveria colocar alerta pra areas risco 	Neutra
dependo gps servico 	Neutra
deveria ficar sempre boas vozes opcao 	Neutra
oi tudo bem queria informar marginal pinheiros 90 km/h so app mostra radares 70 km/h 	Neutra
apesar exibir radar mapa sempre aviso sonoro sobre 	Neutra
ter sinalizador alertas opcao areia curva 	Neutra
estao caminho 	Neutra
aqui bh passando periodo chuvoso parar carro qualquer lugar pode ser sinonimo stress alagamentos 	Neutra
sempre destravo aparelho vejo ja rodando 2掳 plano 	Neutra
"nativo" celular p baixar mapas 	Neutra
ja hora atualizar mapa rua q nome antigo ainda 	Neutra
vi alguns reclamam funcoes sao aparelho nao aplicativo 	Neutra
atualizar mapatem vilas fez ano atras ainda nao 	Neutra
precisamos percorrer ruasnao vai porque veiculo nao passou rua 	Neutra
ser mantido usuarios ficamos sabendo hora congestionamento acidente exemplo 	Neutra
poderia ter usuarios colocarem radares eletronicos velcidade dai ficaria perfeito 	Neutra
gps feito ajudar condutores cada vez tirando opcoes preferido 3 celulares passado hoje serve quebra galho tom tom nao acha endereco volto usar voltar avisar radares 	Neutra
facam favor 	Neutra
informa precisao 	Neutra
so precisa alguns ajustes algumas ruas nao encontra importante calcular sempre caminho curto acaba mostrando caminho longo melhorando item fica top 	Neutra
sumiu gps agora embutido menos opcoes 	Neutra
sei foge proposito util tambem 	Neutra
vamos atualizar localizacoes ne maps 	Neutra
waze melhorar mudo avaliacao 	Neutra
quebra ganho vezes 	Neutra
bom nao dependesse internet 	Neutra
entretanto acho funcao avisa presenca policiais deveria ser excluida pois favorece pessoas estao cnh problemas sequestradores ladroes etc 	Neutra
tentei todas maneiras reconfigurar impossivel unica solucao encontrei utilizar waze 	Neutra
so caminhada trem metropolitano transporta cidade pra outra 	Neutra
avisar radares outro aplicativo concorrente 	Neutra
hoje indo trabalho testei app pois indicou rota contrario sentido deveria ir sendo havia unica via av papa joao paulo i guarulhos guiou bom sucesso sendo ia cecap 	Neutra
ja excelente alguns dias coloco destino traca rota nao acompanha deslocamento carro 	Neutra
faco pra adicionar rua moro mapa 	Neutra
bom vezes informacao desencontradas fica repetindo varias vezes coordenada ja informada 	Neutra
fica tudo atras janelas 	Neutra
informacao estar entrando area risco 	Neutra
fundamental saida programada nao funciona 	Neutra
atualizado nao funciona 	Neutra
precisa atualizar novos mudancas mapa cidades so lugares casa atualizado tudo porque ja mudou visual lugares novos aplicacao presente 	Neutra
gente dedica contribuir mapa local compartilhando conhecimento tempo gente ganha sao apena alguns descontos sentido 	Neutra
regular ficou lento dessa atualizacao 	Negativo
pois dirijo apenas madrugada onde nao transito rota rapida nao sendo rapida dando muita volta necessidade precisa corrigir rapido possivel 	Negativo
lentodao lento retomadas rapidas principalmemte dentro cidades 	Negativo
nao antes favor pessoal responsavel programacao ajeita ai favor 	Negativo
entretanto ultimamente travado bastante tento ver alguma localidade diretamente mapa 	Negativo
modo geral deixa desejar 	Negativo
notei q poucas ruas q nao estao atualizadas 	Negativo
ja tentei configurar aplicativo sucesso 	Negativo
bom ultimamente tracando rotas piores faria conhecer caminho 	Negativo
deus vivo ainda posso relatar ainda 	Negativo
pesquisa voz nao funcionando 	Negativo
porcaria nao entende linha reta rua mostra dirigindo carro lado carrangueijo ja waze nao problemas 	Negativo
so probleminha gente chega endereco corrento avancar uns 5 metros pra falar cheguei destino sendo ja numeracao certa 	Negativo
infelizmente lastima perda dessa funcao 	Negativo
bosta 	Negativo
semana passada ca ficado estranho aparecido procurando sinal gps achei podia ser telefone nao outros gps instalado estao funcionando normalmente preferido waze probleminha usado so vezes espero resolvam rapido possivel 	Negativo
melhor ultimamente anda travando comeca dar problema nao carrega fechar app abrir novamente problema nao telefone pois outros aplicativos continuam rodando perfeitamente 	Negativo
perde pro waze nesse sentido 	Negativo
nao sei ja sao muitos usuarios impressao waze so servindo enderecos nao conheco pq fugir transito  	Negativo
pessoal suporte devem arrumar app fica saindo sozinho tela iniciado trageto fica dando localizacao gps ta travando comeco comecei usar nao travava ficam mechendo app pra melhorar so ta piorando favor corrigem 	Negativo
insiste direcionar caminhos movimentados muitas quebradas nao simplifica caminho 	Negativo
acho ruim vc recebe localizacao aplicativo pede 3 confirmacoes poder comecar rodar 	Negativo
falta seguranca pra saber indentificar areas riscos bom parceria algum app tipo banco dados 	Negativo
ta lixo lixo 	Negativo
consultar mapa zoom diminuido nao pra ver bem ruas 	Negativo
alerta radar alguma curva esquerda nao ver trajeto mapa 	Negativo
errou caminho 	Negativo
gps verdade windows phone 	Negativo
conforme vamos andando trajeto gps nao move 	Negativo
fazem uns dez meses trava direto zenfone 2 toda vez forcar parada 	Negativo
sistema cor transito navegacao confundem ja inviabiliza uso passou hora google atentar atualizar parte grafica app integralo waze levando coisas positivas indicacao faixas transito conversoes 	Negativo
levando locais incorretos aplicativo bom ultimas vezes utilizei levada locais errados caminhos longos tr芒nsito 	Negativo
muitas informacoes desnecessarias tela todo minuto ficar tirando mao volante pra apagar informacoes travando perdendo sinal gps ta pior piores ja melhor todos contrataram nerd pra estragar aplicativo 	Negativo
horrivel nao sei problema android ios funciona perfeitamente android nao abre nenhum mapa app fica instavel fecha sozinho nao funciona nada 	Negativo
pois 3 anos endereco mostrando local erradoja tentei tudo pra arrumarem nada fazendo clientes ir pra outro endereco 	Negativo
po fica desejar parece caras estao preguica passar algumas ruas 	Negativo
agil recalcular nova rota porem colocou ruas contramao nao pode acontecer vindo app alta qualidade espero arrumado urgencia 	Negativo
gostaria ver cidade la bahia nao aparece atualmente 	Negativo
hora melhorarem 	Negativo
absurdo subir serra 3km pra retorno vez destino frente 	Negativo
porcaria aqui nao serve gps 	Negativo
alguns lugares centro rio janeiro tijuca perde sinal 	Negativo
ponto negativo algumas vezes oferece rotas dando voltas passando locais perigosos 	Negativo
pena litoral sul bahia precisamente br 327 sentido porto seguro nao reconhece radares fica desorientado trajeto 	Negativo
ja desinstalei instalei novamente varias vezes 锚xito 	Negativo
apesar usar todo dia dou 01 ter ficar atento realmente certo 	Negativo
ultima atualizacao usar app transportes nao funciona direito vc coloca navegacao nao vai agora tela navegacao direto passa monte tela estacionamento antes amor deus arrumem 	Negativo
ficou ruim 	Negativo
ja bom porem ruim 	Negativo
nao pra visualizar cidades rodovias rios lagos afasta mapa 	Negativo
so informacao area risco nao informacao suficiente 	Negativo
simplesmente nao quero nao preciso 	Negativo
atualizar imagens locais estao pouco antigas 	Negativo
suspendi uso ultima utilizacao 	Negativo
deixa desejar termos fluidez claro depende configuracao celular 	Negativo
to enfrentando problemas procurar bairros recentes ds cidade 	Negativo
precisa atualizarmuitas vezes coloca gente contra mao ate escadarias 	Negativo
bem desatualizado lugares virou contra mao 	Negativo
retirou recurso basico essencial opcao escolher rota rapida curta 	Negativo
propaganda demais semaforos 	Negativo
app ja mandou pra dentro favelas 	Negativo
mesmos erros localizacao mesmas imprecisoes 	Negativo
android atualizou 7 maps nao funciona corretamente 	Negativo
porem aki fortaleza aparece alguns erros trajeto 	Negativo
so demorando carregar demora achar cidades selecionadas usando net casa 8mb fibra optica 	Negativo
parte mudanca rota nao rapido precisa ser melhorado alguns ambientes sinal gps cai falha tambem precisa melhorar 	Negativo
ainda pra melhorar principalmente bussola 10 anos voce vira carro gps reage ate mexer voce ja perdeu entrada trabalha passa raiva 	Negativo
lento 	Negativo
casa atualizacao falha 	Negativo
ponto fraco nao poder adicionar 10 paradas sistema bom	Negativo
ponto azul vezes mexe 	Negativo
bom pena s贸 deixar reportar algum acontecimento cima local pois assinalamos algo passando fica sitio 	Negativo
nao funciona sistema voz facilitaria navegacao reportar algum problema estrada ter fazer manualmente prejudica aplicativo 	Negativo
so atualizar algumas coisas 	Negativo
fiquei pouco preocupado app levou lugar diferente 	Negativo
deixem opcao la disponivel gente fazer download mapa cidade estado inteiro rota inteira pra rodar offline caramba 	Negativo
vezes nao captura sinal gps faz abra mapsocorre normalmente ligo desligo gps celular visando economia bateria 	Negativo
motorola x force nao funciona bug diz "sem sinal gps" 	Negativo
bosta sempre desistalo instala automaticamente novo 	Negativo
falta alguns ajustes tipo locutor robotico 	Negativo
poderia ser melhor 	Negativo
lamentavel 	Negativo
momentos some 	Negativo
so fica meio estranho algo lugares rota continua erro caminho diferente 	Negativo
apenas gostaria salientar nao acho interessante aplicativo disponibilizar possibilidade informar existencia viaturas policiais percurso facilita transito criminosos vai contra seguranca publica 	Negativo
motivo nao uso frequencia consumo gigantesco bateria 	Negativo
muitos erros trajeto paro farol comeca recalcular diversas rotas parar sempre erro sinal gps etc espero arrumem 	Negativo
deveria mostrar radar perde gps trav nao conecta novamente reiniciar aparelho 	Negativo
nao ta aparecendo rotas perto vc coloca pra ir pra lugar escolhe longe consertem rapido 	Negativo
consertem quanto antes 	Negativo
algumas ruas aparecem mapa desaparecem durante navegacao 	Negativo
poderia ser revisto funcionalidade horarios trens metros alem linhas onibus muitas vezes nao sao encontradas incorretas 	Negativo
app fica buscando sinal gps toda hora 	Negativo
reseta volta ingles 	Negativo
lento demais mostrar radares mostrar painel velocidade 	Negativo
lento vou fazer entregas derruba demora pra mostrar direcao pra q lado ir  trava muitoo lentoo 	Negativo
agora sai rota sempre fica recalculando direto ja fez cair lugares perigosos 2x 	Negativo
ate desgosto ter app celular melhorem favor 	Negativo
porcaria 	Negativo
ultima utilizacao ficou bosta ruim tao ruimestou usando outra vista google maps menos nao fica saindo sinal resumindo ta lixo 	Negativo
nao consigo acessar absolutamente nenhuma funcionalidade malditos anuncios estao firmes fortes 	Negativo
informacao poderia ter salvado vidas passado pode salvar vidas futuro 	Negativo
ia fazer rota mapa nao ia pra frente 	Negativo
pena 	Negativo
vezes odeio app porque imagens sao muita antiga irrita  melhorem favor 	Negativo
voce passa trajeto so mostra pra virar duas ruas antes 	Negativo
trava demais 	Negativo
nao avisa sobre area risco carrega eternamente 	Negativo
dificuldade mudar rota vc sabe dum trajeto melhor nao mostra nomes ruas paralelas bom 	Negativo
ja reinstalei umas duas vezes nao resolve 	Negativo
creio q ultima atualizacao aplicativo nao vem funcionando bem diversas vezes fica procurando rede motorista app gosto utiliza lo porem ultimos tempos dificil acho otimo app deixando desejar momento 	Negativo
nao interessante nao dar pra mudar rota adicionar paradas evitar alguma passagem alem ter interface basica menu suporte nao funciona 	Negativo
ajuda bastante ajuda bastante vira mexe deixa mao falta sinal rede 	Negativo
so nao navegando aplicativo enquanto ouvir musica porque tende desligar mp3 gostaria saber porque nao posso utilizar aplicativo ja telefone multifuncional 	Negativo
nao gostei colocou estrada terra 100 km 	Negativo
waze funciona bem melhor 	Negativo
ruim ruim 	Negativo
semana duas situacoes desagradaveis relacao trajeto sugerido app 	Negativo
trabalho uber ai antes apertava navegar ia certinho agora faz monte perguntas antes ir destino favor ver ae 	Negativo
porque app otimo desenvovedor resolve estragar tudo  maps ficou horrivel primitivo nocao completamente desnecessario 	Negativo
nao antes trava nao reconhece trajeto determinadas cidades interior sao paulo ja passei problema desenvolvedores nao obtive retorno nao sei vou continuar 	Negativo
comeco funcionou deichou mao 	Negativo
ja aconteceu comigo florianopolis bem assustador 	Negativo
vezes traca uns caminhos ziguezague deixa puto 	Negativo
parece espera vc movimentar pra troca ponto origem seta entanto google maps nao reconhece movitacao ponto persiste carro movimento 	Negativo
ficou horrivel gps nao consigo ver nomes ruas durante durante navegacao so mostra onde ir nao mostra nomes ruas antes nao assim gosta desse aplicativo indiquei muitas vezes agora ja nao indico pois ficou ruim 	Negativo
ta falhando 	Negativo
precisa deixa maodiz sinal internet mentira desastre horrivel nao recomendo 	Negativo
maps fica dando mensagens erro tento abrilo tambem nao abrindo 	Negativo
nao verdade 	Negativo
so nessa ultima atualizacao deixou grande falha questao orientacao voz nao funciona favor equipe arrumem nao permanece bug resolver ai sim darei 5 estrelas 	Negativo
s贸 pq nao outro pessimo porem waze pior 	Negativo
antes bom 	Negativo
gostava mto utilizar maps porem qdo troquei celular moto g play comecou travar acabar atrapalhando trajetos 	Negativo
nao consegue redefinir rota 	Negativo
ja funcao gps acho bem fraca principais funcoes falta sao mostrar radares fixos mostrar velocidade permitida rua trafegando funcao offline deveria ser estado nao area agora 	Negativo
nao faz caminho antigamente apenas perspectiva cima 	Negativo
so problema facil ser arqueado 	Negativo
propagandas sao chatissimas tambem 	Negativo
falha zenfone 5 asus lerdo nao carrega direito precisa arrumar urgente pois apo util funciona direito 	Negativo
podia ser melhor atualizado 	Negativo
ultimas atualizacoes estragaram app melhor antes principalmente linha azul qi atrapalha navegacao 	Negativo
nao quero app google forca instalacao querer mem贸ria gadget 	Negativo
ola ano usuaria gps brasil aparelho porem pos ultima atualizacao sempre sinal gps tbm sinal fica voz som favor avaliada pq gosto apk 	Negativo
resumindo inutil 	Negativo
trabalho app dias ruim nao sair ponto azul seta demora aparecerse passa ruim arvores app fala sinalantes dessas atualizado app otimo agora ruim fica sinal sinal normalmente favor tenta fazer atualizacao melhor 	Negativo
nao consegui escolher trajeto so deu duas opcoes fixas 	Negativo
atrapalha experiencia usuario 	Negativo
dando diferenca tempo real atrasado pouco localizacao voz proprio carrinho 	Negativo
ja melhor hj mim piorpor ser online deveria ser preciso porem sinal celular perfeito gps perde sinalacusa outro lugar nada vermuita atualizacao desnecessarios estragou app 	Negativo
so vejo imagens antigas lugares dez anos atras 	Negativo
nova atualizacao nao boa 	Negativo
toda vez clico mudar idioma nunca muda 	Negativo
l lento extremo 	Negativo
ser seguido nao quero 	Negativo
primeiro gasta imensos dados moveis porque precisa sempre internet mapa 	Negativo
retiraram opcao rodizio veicular calcula tempo errado muita vezes tira rota jogar totalmente engarrafada so fato ser 7 minutos rapida 	Negativo
concorrencia qualidade acaba acontecendo waze 	Negativo
app bom comecou travar samsung j5 parei usar achando aparelho troquei lg q6 continuou atualizei vou ver melhorar dou 5  	Negativo
contar proprio google maps piorou 	Negativo
precisa melhorar ficar ruim 	Negativo
celular moto g4 play nao funcionando aplicativo nao saio lugar quase ano uso celular nao consigo usar ja tentei varias vezes queria resolvessem problema 	Negativo
vou desinstalar 	Negativo
poxa aplicativo nao reconhece diferenca pista lateral pista central rodovias 	Negativo
aplicativo comecando dar erros fica ruim condutor assim nao nao internet dando uns atrasos localizacao 	Negativo
modo paisagem todo bugado 	Negativo
atualizacao nao dar ver "meu local" preciona botao nao consegue achar 	Negativo
nao recupera perfil 	Negativo
toda hora "sem sinal gps" 	Negativo
ja quase acidentei horrivel 	Negativo
encontra posicao porem traco destino pressiono "ir" simplesmente diz ter perdido sinal gps 	Negativo
agora so aparece falha comunicacao servidor rotas nao calcula rota nenhuma 	Negativo
consigo navegar propagandas nao consigo fazer rota sequer 	Negativo
ultima atualizacao travando 	Negativo
porem apos ultima atualizacao nao opcao caminho curto rapido navegacao deste dias atras mandou via rapida passava favela saia av hebe camargo 	Negativo
