ja auxiliou muitas situacoes dificeis 	Positivo	1	-1
bom sempre atualizado 	Positivo	2	-1
bom bom 	Positivo	2	-1
muitas funcoes excelentes todas pessoas desde naturais cidade ate turistas 	Positivo	1	-1
bom 	Positivo	2	-1
tipo app otimo app souber usar 	Positivo	2	-1
otimo poderia pedir pra voltar engano pegou caminho errado perguntar antes criar automaticamente outra rota 	Positivo	1	-2
bom 	Positivo	2	-1
aplicativo bom 	Positivo	2	-1
app bom 	Positivo	2	-1
observacao excelente bom 	Positivo	2	-1
achei eficiente 	Positivo	1	-1
aplicativo perfeito consigo fazer absolutamente tudo preciso lugares distantes quer errar rua otimo pessoas reclamam sao pessoas querem aplicativo levem tente raciocinar minimo possivel 	Positivo	2	-2
engracado maps informar ate faixa vc deve tomar qdo dirige 	Positivo	1	-2
geral ajuda bastante uso bom senso escolha opcao trajeto 	Positivo	2	-1
olha waze pra min bom 	Positivo	2	-1
melhorar 	Positivo	2	-1
bom excelente aplicativo nao pesa cel deixa localizacao exata 	Positivo	2	-1
bom bom 	Positivo	2	-1
bom porem vou dar 3 estrelas porque bluetooth nao funciona deveria carro (fox) 	Positivo	2	-1
otimo tanto carro pe 	Positivo	1	-1
merece 5 estrelas podem baixar vale pena desinstalado instaleio novamente agora descobri simular navegacao antes iniciar viagem 	Positivo	1	-2
gostei programa 	Positivo	3	-1
usei alguns lugares off deu certo logico lugar q so online muitos lugares tracou rota offline mui bom 	Positivo	2	-1
app bom 	Positivo	2	-1
bom 	Positivo	2	-1
otimo app identificar trajeto destinatario ajuda transitar seguranca principalmente alertando sobre divergencias transito importante aponta onde estao radares velocidade enche bolsos governos nao fazem nada pra melhorar condicoes condutores 	Positivo	2	-1
melhor ate atualidade favor nao estraguem fantastico :) :) 	Positivo	3	-1
otimo ajuda diariamente todos percursos funciona bem sii 	Positivo	2	-1
nao enfia furada favelas 	Positivo	1	-1
lg gosteimuito exelente 	Positivo	1	-1
obom tbm pega internet adorei ja resolvem problemas nao presisso compra gps pq internet celular lento app aprovado nova atualizacao focou dificio mecher 	Positivo	1	-2
waze salva vida bom hj ja faz parte todas saidas carro nao sair nao ligar antes 	Positivo	2	-1
app otimo principalmente off line 	Positivo	1	-1
sergio menezes ola bom 	Positivo	2	-1
app bom cada dia sido otimas melhorias 	Positivo	2	-1
otimo aplicativo leva enderecos erros contar avisa onde radares 	Positivo	1	-1
util escolher trajeto rapido 	Positivo	1	-1
resto ta bom 	Positivo	2	-1
waze melhor aplicativo mundo ganha pao melhor aplicativo transito mundo 	Positivo	2	-1
bom 	Positivo	2	-1
bom poderia ter opcao leiaute exibisse mapa parabrisa fazem outros app (como hudway go exemplo) 	Positivo	2	-1
hallecs gostei 	Positivo	3	-1
demais recursos sao excelentes 	Positivo	1	-1
otimo app 	Positivo	1	-1
excelente 	Positivo	1	-1
nao pesado internet pode estar ate fraca porem assim ainda continua funcionando 	Positivo	1	-2
maps economico materia consumo dados otimo uso 	Positivo	1	-1
maximo excelente aplicativo 	Positivo	1	-1
adoro waze ajuda bastante tracar melhores rotas 	Positivo	1	-1
mto bom 	Positivo	2	-1
bom 	Positivo	2	-1
recomendo todos querem ocupar memoria celulares terem pessimos momentos vida claro recomendo principalmente querem perder tempo dinheiro 	Positivo	1	-2
bom 	Positivo	2	-1
tô gostando bastante app vcs pediram abrir app ja soubesse caminho avisaria radares etc 	Positivo	1	-1
top 	Positivo	1	-1
adoro 	Positivo	1	-1
funciona bem 	Positivo	2	-1
otimo 	Positivo	1	-1
gosto 	Positivo	3	-1
estradas portugal bom 	Positivo	2	-1
bom sempre uso 	Positivo	2	-1
ate momento sido bom aplicativo 	Positivo	2	-1
realmente util 	Positivo	1	-1
otimo servico bom 	Positivo	2	-1
ainda melhor maps sendo assim melhor aplicativo gps 	Positivo	2	-1
bom bom jogar pokemon go 	Positivo	2	-1
bom 	Positivo	2	-1
otimo gostaria desse pra baixar dados telemetria baixa strava 	Positivo	1	-2
perfeito dica vocês deviam botar ferramenta calcular quantidade combustivel gasta ponto outro 	Positivo	2	-1
facilidade indicar rua dizer nome ajuda cidades nao conhecemos 	Positivo	1	-1
inicio bom rodava ate longo caminho offline 	Positivo	2	-1
otima ideia perfeito 	Positivo	2	-1
app bom 	Positivo	2	-1
bom ajuda trânsito ja trabalho motorista recomendo todos 	Positivo	2	-1
consegui livrar transito economizar menos 30min paciencia mta gasolina 	Positivo	1	-2
viagem sao paulo minas gerais problema algum precisao informacoes otimas bom 	Positivo	2	-2
bom 	Positivo	2	-1
tony top uso faco entregas lanche nao sei pesquiso map rapido pratico 	Positivo	1	-1
bom 	Positivo	2	-1
cumpre promete 	Positivo	1	-1
excelente facil usar excelente programa novo visual ficou bacana facil utilizacao 	Positivo	1	-1
bom 	Positivo	2	-1
excelente aplicativo melhor gps todos ja usei rotas precisas nunca deixou mao nunca jogou lugares errados nao reclamar 	Positivo	2	-1
bom 	Positivo	2	-1
indiquei todos amigo perfeito parabens melhor so falta algumas atualizacoes velocidade perfeito indico todos precisem gps off 	Positivo	2	-2
perfeito mostra velocidade via tela velocimetro melhor tudo trânsitose bom ruim 	Positivo	2	-2
melhor ate agora bom 	Positivo	2	-1
excelente aplicativo melhor gps ja baixei rotas nitidas nunca deixou mao recomendou ainda nao precisa internet 	Positivo	2	-1
super preciso 	Positivo	3	-1
app utilidade publica n 1 imprescindivel 	Positivo	1	-1
bom 	Positivo	2	-1
show excelente aplicativo 	Positivo	1	-1
toda certeza melhor aplicativo gps sistema offline atualidade sistema navegacao preciso opcoes escolher melhor rota avisos radares visiveis nao visiveis pista orientacao visual limpa legivel opcoes pontos turisticos etc simplesmente otimo trabalho continuem assim usuarios possamos indicar fazer comunidade crescer cada vez 	Positivo	2	-1
excepcional melhor app mapas gps 	Positivo	2	-1
pra mim oculos nao saio casa super recomendavel melhor gps 	Positivo	3	-1
gps bom ótimo app 	Positivo	2	-1
adorei 	Positivo	1	-1
otimo bom 	Positivo	2	-1
bom gracas app posso andar cidade preocupar sendo grandepor dai app ajuda caminhos cidade :) 	Positivo	2	-1
pessoas perdem tempo weize google maps informa bem melhor caminho transito real rodovias pistas serio problema destes aplicativos esquenta demais celular 	Positivo	2	-2
adorei 	Positivo	1	-1
bom cristo 	Positivo	2	-1
excelente ate agora 	Positivo	1	-1
bom 	Positivo	2	-1
otimo 	Positivo	1	-1
gps incrivel 	Positivo	1	-1
programa maps si bom ja funcao gps acho bem fraca principais funcoes falta sao mostrar radares fixos mostrar velocidade permitida rua trafegando funcao offline deveria ser estado nao area agora 	Positivo	2	-2
excelente excelente 	Positivo	1	-1
otimo ate hoje 	Positivo	1	-1
bom recomendo 	Positivo	2	-1
bom 	Positivo	2	-1
uso horas todo dia 	Positivo	1	-1
melhor 	Positivo	2	-1
bom bom 	Positivo	2	-1
otima ferramenta localizacao 	Positivo	1	-1
equilibrio uso off line dados eficiente 	Positivo	1	-1
recomendo 	Positivo	1	-1
gostei 	Positivo	3	-1
atual aparelho funcionamento perfeito 	Positivo	2	-1
bom melhor muitos aplicativos ai 	Positivo	2	-2
aplicativo mudou vida relacao itinerarios 	Positivo	1	-1
perfeito bom 	Positivo	2	-1
otimo 	Positivo	1	-1
bom 	Positivo	2	-1
bom sao paulo voltei cem problemas moca poderia informar velocidade radares 	Positivo	2	-1
otimo 	Positivo	1	-1
bom 	Positivo	2	-1
app eficaz necessario hj dia 	Positivo	1	-1
fiz viagem 720 km sempre avisou radares certinhos 	Positivo	1	-1
otimo app viajei 1125 tudo certinho recomendo    	Positivo	1	-1
satisfacao 	Positivo	1	-1
deixou vida pratica 	Positivo	1	-1
excelente aplicativo achei preciso gps acho algumas ferramentas podem ser aperfeicoadas exemplo disponibilizacao acesso funcionamento aplicativo locais onde nao ha internet 	Positivo	2	-1
valeu 	Positivo	1	-1
bom excelente 	Positivo	2	-1
muitas vezes vou trabalho pra lugar nunca guia certinho 	Positivo	1	-1
ja melhor 	Positivo	2	-1
app otimo sempre levou lugares corretamente nao reclamar 	Positivo	1	-1
ajuda 	Positivo	1	-1
otimo ja usava oi mapas 	Positivo	1	-1
excelente 	Positivo	1	-1
mim otimo #curto bastante so detalhe vezes parados acha andando dai pede pra colocar passageiro 	Positivo	1	-1
bom so nao diferencia carros caminhao 	Positivo	2	-1
app bom 	Positivo	2	-1
bonzinho vcs sabem td graca melhor pois off vai melhor 	Positivo	2	-1
procurando exatamente gps assim smartphone 	Positivo	1	-1
bom recomendo 	Positivo	2	-1
aconselho pessoas baixarem 	Positivo	1	-1
ajuda 	Positivo	1	-1
bom quase sempre certo  	Positivo	2	-1
melhor gps duvidas completo melhor gps gratuito 	Positivo	2	-2
bom excelente taxistas passageiros pedem ligalo 	Positivo	2	-1
mto util 	Positivo	1	-1
bom d  ja ajudou principalmente lugares nao conheco 	Positivo	2	-1
bom aplicativo 	Positivo	2	-1
mto bom gostei 	Positivo	3	-1
excelente melhor qualquer gps 	Positivo	2	-1
recomendo todos 	Positivo	1	-1
bom 	Positivo	2	-1
mapas parabens otimo bem organizado 	Positivo	2	-1
hoje considero uso waze indispensavel qualidade vida ja nao perdemos tanto tempo transito 	Positivo	1	-1
adorei 	Positivo	1	-1
app bem util 	Positivo	2	-1
pra perdido lugar outra cidade grande gps nota 10 	Positivo	3	-1
bom aplicativo 	Positivo	2	-1
melhor 	Positivo	2	-1
excelente sempre tira trânsito pesado 	Positivo	1	-2
bodyboader util 	Positivo	1	-1
aplicativo bom 	Positivo	2	-1
experiencia navegacao app sempre positiva 	Positivo	1	-1
top 	Positivo	1	-1
otimo 	Positivo	1	-1
bom acho historico destinos percorridos ajudaria 	Positivo	2	-1
bom bom 	Positivo	2	-1
bom maravilhosos aqui sao paulo capital interior melhorada hoje rua quer nao mao dupla hoje contra mao cidade muda transito voce nao acompanhar mudanca tempo real 	Positivo	2	-2
bom 	Positivo	2	-1
otimo app mapas navegacao tempo real poderia possuir recursos alimentacao usuarios tecnicos transito facilitar locomocao funcionalidade transporte 	Positivo	1	-1
bom uso taxi 	Positivo	2	-1
precisao eh incrivel 6 estrelas 	Positivo	1	-1
bom sempre ajuda 	Positivo	2	-1
aplicativo fantastico permite inclusive fazer simulacao rota nao surpresas caminho 	Positivo	1	-1
bom 	Positivo	2	-1
ha mto tempo procurava navegador gps off line eficienteeste superou mhas espectativaspodem baixare parabens desenvolvedores 	Positivo	2	-1
uso 	Positivo	1	-1
aplicativo util 	Positivo	1	-1
parabens desenvolvedor 	Positivo	1	-1
tô adorando uso gps brasil ha tempo 	Positivo	2	-1
otimo aplicativo 	Positivo	1	-1
otimo 	Positivo	1	-1
bom excelente 	Positivo	2	-1
otimo sempre mantenho atualizado bom 	Positivo	2	-1
gostei 	Positivo	3	-1
dom pesca utiliza waze uso app organizar viagens pesca lazer 	Positivo	1	-1
bom 	Positivo	2	-1
Òtimo bom adorei 	Positivo	2	-1
melhor aplicativo offline ja vi recomendo 	Positivo	2	-1
imbativel navegador 	Positivo	1	-1
excelente primeira vez q usei levou certinho endereco ainda caminho curto bom 	Positivo	2	-1
otimo 	Positivo	1	-1
b bom 	Positivo	2	-1
bom extremamente util definir rota rapida trechos rotina 	Positivo	2	-1
melhor parte deste app mapa offline pra usar gpsusei ontem incrivel 	Positivo	2	-1
show app essencial pena nao pra ver blitz 	Positivo	1	-2
waze bom 	Positivo	2	-1
melhor aplicativo ja usei 	Positivo	2	-1
colocar recurso app sera melhor todos 	Positivo	2	-1
sinal operadora eh perfeito 	Positivo	2	-1
bom adorei 	Positivo	2	-1
bom importante 	Positivo	2	-1
app util pratico 	Positivo	1	-1
melhor aplicativo existe taxistas 	Positivo	2	-1
aprovado 	Positivo	1	-1
recomendo bom nunca problemas melhor equipamento gps 	Positivo	2	-1
bom app ajuda demais diaadia 	Positivo	2	-1
bom 	Positivo	2	-1
geovanna bom 	Positivo	2	-1
bom sempre certo procurobom 	Positivo	2	-1
prevê tempo viagem precisao 	Positivo	1	-1
opcao usar smartphone dash can filmar trajeto possivel duas cameras smartphones boa potência hardware 	Neutra	2	-1
nesta ultima atualizacao nao encontrando opcoes escolha rota curta/rota rapida" abracos 	Neutra	1	-1
porem travou algumas vezes corrigindo detalhe completo 	Neutra	1	-1
ajuda ruas nao funciona 	Neutra	1	-1
gente dedica contribuir mapa local compartilhando conhecimento tempo gente ganha sao apena alguns descontos sentido 	Neutra	1	-1
bom pena nao rotas off line pe transporte publico 	Neutra	2	-2
fica so calculando transito nao podemos perder tempo 	Neutra	1	-2
sugestao acho app poderiaassim aberto perguntar condutor carro passeio caminhao 	Neutra	1	-1
onde exatamente fica boca fumo vc nao desavisado determinado local 	Neutra	1	-1
nome rua numero bairro cidade quantidade quilometros percorridos titulo viagem pra serem visualizadas agenda 	Neutra	1	-1
coloca escala menor (maior precisao informacoes) coloca visualizacao "por dentro" mapa melhor ainda pra melhor entendimento 	Neutra	2	-1
indicar areas risco 	Neutra	1	-2
tavares dificil 	Neutra	1	-1
otimo porem muitas pessoas relatam sempre manda rua rua paralela avenida principal podendo colocar ruas esburacadas etc 	Neutra	1	-1
bizarro google maps iphone funciona melhor android 	Neutra	2	-2
nao pontuado ha tempos 	Neutra	2	-1
sumiu gps agora embutido menos opcoes 	Neutra	1	-1
poderia ter opcao caminhao onibus pois sempre veiculos maiores conseguem trafegar vias estreitas 	Neutra	1	-1
otimo agora coloco destino mostra rota nao acompanha deslocamento carro 	Neutra	1	-1
nao assim meses atras 	Neutra	1	-1
corrijam favor voltem ser melhor app 	Neutra	2	-1
ultima atualizacaovcs tiraram voz alessandra (brasil) colocaram portuguesnada contra porque nao incluir vozes inves substituir 	Neutra	1	-2
alguns momentos fala outros fica mudo fazendo vc ver ouvir 	Neutra	1	-2
deixem maps navegacao carro formato seta igual wase 	Neutra	1	-1
excelente aplicativo deveria ser completo exemplo mostrar radar certeza voces tecnologia suficiente acrescentar 	Neutra	1	-1
google maps 	Neutra	1	-1
programa maps si bom maior problema perca sinal gps conectado 4g nao perde sinal gps conexao muda pra h  perde conexao gps hora demora uns minutos pra voltar logo perde novamente conexao muda pra h nao perde sinal gps problema conexao h  nao sei pq interfere sinal gps 	Neutra	2	-2
deveria ser possivel escolher rua indicar passa la 	Neutra	1	-1
nao conseguindo pedi so fica dando tente novamente tarde 	Neutra	1	-1
boa noite conta waze logado uns 3 anos mudei aparelho nao consegui recuperar conta bem avancado chegando ultimo nivel voces poderiam ajudar recuperar conta 	Neutra	2	-1
acendimento app entende noite entanto nao acaba atrapalhando visualizacao sistema multimidia carro (que espelhamento app) 	Neutra	1	-1
hoje 17h dizia levaria 3h ir cabo frio rio 	Neutra	1	-2
ter voz 	Neutra	1	-1
nao esperar varias telas ate navegacao 	Neutra	1	-1
cabeca pra baixo tbem pra entender 	Neutra	1	-1
vou testar hoje nova atualizacao motociclistas 	Neutra	1	-1
quebra ganho vezes 	Neutra	1	-1
precisa uns ajustes ótimo viessem versao português instrucoes editar mapas 	Neutra	1	-1
falta haver opcao poder descarregar rota/mapa caso viagens paises nao ter trafego dados poder ter mapa/rota offline 	Neutra	1	-2
deveria avisar sempre visto voce nao fica dirigindo olhando mapa 	Neutra	1	-1
so caminhada trem metropolitano transporta cidade pra outra 	Neutra	1	-1
tipo clik tela superior inferior sumia deixando assim visao mapa rota livre 	Neutra	3	-2
so falta funcao pra caminhoes geralmente sao rotas diferente iria ajudar trabalha transportes cargas 	Neutra	1	-2
outros aplicativos google maps funcionam normalmente mim 	Neutra	1	-1
pratico porem sinal internet fraco google maps bem melhor 	Neutra	2	-2
bom ficar atento ver mapa antes sair casa 	Neutra	2	-1
entao resposta vc motorista pode fazer rota" chega ser malcriada algumas situacoes 	Neutra	1	-1
informar mudanca sentido via 	Neutra	1	-1
querendo ver local iremos passar nao conhecemos nao 	Neutra	1	-1
habilitando opcao hud seguranca usuarios waze aumentara consideravelmente 	Neutra	1	-1
desative notificacoes continuam sons popups qualquer momento usar aplicativo 	Neutra	1	-1
sugestao ordenacao data postagem comentarios atual antiga 	Neutra	1	-1
antigamente tinhas rotas transporte publico perfeitas hoje so indica onibus intermunicipais 10 reais pra cima optei citymapper 	Neutra	1	-1
outra sugestao poder tracar percurso pe offline 	Neutra	1	-1
nao falo so mim falo todos local guides contribuem maps ficar melhor receber fato merecem 	Neutra	2	-1
vamos atualizar localizacoes ne maps 	Neutra	1	-1
botao desligar servicos vezes perceber onde rua 	Neutra	1	-1
bem vcs poderiam criar igone dentro app salvar rota vc faz carro rua ruanao ponto outro linha reta linha tempo ajudaria pessoal ussa trabalho maps 	Neutra	2	-1
vcs atualizam gps continua jeito 	Neutra	1	-1
coloquem opcao montar etinerarios diversos pontos parada melhor rota passagens pontos ia ser perfeito profissionais 	Neutra	2	-1
favor ajustar isso   	Neutra	2	-1
bom atualizar ser rapido 	Neutra	2	-1
gostei opcao rotas alternativas "mais rapidas" tempo real m ainda melhorar 	Neutra	3	-1
pois nao todos lugares gente internet nao poxa 	Neutra	1	-1
apesar exibir radar mapa sempre aviso sonoro sobre 	Neutra	1	-1
mes q mandei correcao ainda nada 	Neutra	1	-1
ja configuracoes nao vi retirala 	Neutra	1	-1
nunca fico perdido tirem idiotice mapa offline ter ser atualizado cada 30 dias 	Neutra	1	-1
problema bolinha azul muitos estao relatando ai formatei celular problema acabou 	Neutra	1	-2
parece estar ponta cabeca 	Neutra	1	-1
aplicativo procura localizacao 	Neutra	1	-1
tipo poder trocar pontos recompensas creditos playstore produtos empresas associadas google 	Neutra	2	-1
estranho talvez ser focado celular 	Neutra	1	-2
preciso navegar nao aparece seta azul somente ponto azul cima mapa nao encontrei solucao 	Neutra	1	-1
so precisa alguns ajustes algumas ruas nao encontra importante calcular sempre caminho curto acaba mostrando caminho longo melhorando item fica top 	Neutra	1	-1
titulo exemplo criacao pasta "restaurantes" onde possivel guardar nessa mesma pasta localizacoes restaurantes interesse 	Neutra	1	-1
assim filma 2 arquivos externo interno 	Neutra	1	-1
ainda nao usei via urbana 	Neutra	1	-1
propria voz gps (um aplicativo externo pra fazer caso) ganhar pontos ajudar melhorar mapa trocar itens 	Neutra	2	-1
deveria atualizar ruascasas etc 	Neutra	1	-1
toda vez busco endereco tento fazer caminho transporte publico maps aparece mensagem trajeto nao encontrado 	Neutra	1	-1
segui sugestao trajeto maps cheguei local embarque balsa mesma nao horario funcionamento 	Neutra	1	-1
so nao dou 5 estrelas porque deixou desejar faltando opcao adicionar diversas paradas otimizar caminho 	Neutra	1	-1
menos celular deitado acontece 	Neutra	1	-4
alem coletar dados usar poderiam funcionar deve 	Neutra	1	-2
hoje marginal pinheiros limite velocidade velocidade 90 app ainda 70 subir ponte octamendez ficar pista local pegar ponte app mandou ir pista expressa passei ponte ficou pedindo retorna 	Neutra	1	-2
funcao transporte publico nao disponivel 	Neutra	1	-1
seta azul comeca andar pra tras 	Neutra	1	-1
realmente aplicativo uso qualquer lugar va so poderia avisar onde estao instalados radares acho completo 	Neutra	1	-1
observacao quanto localizacao radares br163 	Neutra	1	-1
ultimamente notado abrindo sozinho celular 	Neutra	1	-1
poderia ter opcao colocarmos trânsito livre atualizar demais usuarios 	Neutra	1	-1
acabei baixar ja informado app nao sera otimizado tabletmesmo assim vou testar uso bastante aqui sao paulo outros app deixado mao bom dou nota maior 	Neutra	2	-2
dados mapa cidades menores sao pouco atualizados 	Neutra	1	-1
app tambem fecha sozinho varias vezes 	Neutra	1	-1
talvez ate ja nao consegui achar 	Neutra	1	-1
poderia ter antecipacao faixa via rapida marginal app so mostra manter direcao 	Neutra	1	-2
atualizem resolver problema 	Neutra	1	-2
ja excelente alguns dias coloco destino traca rota nao acompanha deslocamento carro 	Neutra	1	-1
tom tom faz bem nao propaganda nao informacao util procurando gps funcao realmente funciona 	Neutra	2	-2
2 funcionalidades sinto falta sao: 1) modo noturno durante dia 	Neutra	1	-2
ja hora atualizar mapa rua q nome antigo ainda 	Neutra	1	-1
espero corrijam pois comentarios problema parece ser motivo reclamacao varias pessoas 	Neutra	1	-2
pq todo mundo usa pra sair engarrafamentomuitos usam pra saber caminho 	Neutra	1	-1
app bom atualiza ocupa espaco android dificulta vida usuario quer baixar alguem aplicativo jogos musicas videos etc 	Neutra	2	-2
atualizou mapa fica cabeca baixoe conforme voce vai entrando ruas ficar girando celular junto poder acompanhar 	Neutra	1	-1
vi alguns reclamam funcoes sao aparelho nao aplicativo 	Neutra	1	-1
agora voces podem incrementa icone aba pra marcamos lugares ja visitamos linkar google trips assim vai virar vicio querer deixar tudo marcado visitar tudo mundo jogo fim    	Neutra	1	-1
q ficar cadastrando tudo novo 	Neutra	1	-1
informa nao rede 	Neutra	1	-1
usando espelhamento android auto mylink carro (multimidia original chevrolet) ligar farois mapa fica tema noturno 	Neutra	1	-1
Ñ fala distância correta ate local 	Neutra	1	-1
ideal nestes casos deixar celular fixo rede 3g 	Neutra	1	-1
ótimo maes lento 	Neutra	1	-2
classe caminhao acho falta atualizacao ajudar motoristas caminhoes informacoes sobre vias trânsito restrito horarios restricoes 	Neutra	1	-2
corrigir ai vai pro 10 	Neutra	1	-2
"o futuro" pede maior interatividade ordens voz exemplo "ok google compartilhar rota com" recomendo google mapas 	Neutra	1	-1
anuncios nele hora iam aparecer graca relogio trabalha 	Neutra	1	-1
agora ficar digitando nome cidade nome rua 	Neutra	1	-1
mylink 2 android auto face obrigatoriedade uso farol baixo rodovias durante dia google maps assume modo noturno forma automatica ligar farol atrapalha visibilidade 	Neutra	1	-1
menos bom 	Neutra	2	-1
boa ferramenta transitomais vezes fica louco faz caminho longos demora atualizar transito melhora atualizado vezes muda configuracoes sozinho 	Neutra	2	-2
leva ummilebio pra corrigir atualizar rota 	Neutra	1	-1
esperando atualizacao 	Neutra	2	-1
aqui bh passando periodo chuvoso parar carro qualquer lugar pode ser sinonimo stress alagamentos 	Neutra	1	-2
nao conseguindo fazer downloads areas off resolvam 	Neutra	1	-1
bom porem ja entrei favela causa deus nao ouve nada comigo coloquei caminho enviou lugar comoletamente diferente rota 	Neutra	2	-1
melhorando cada atualizacao bom comecou ficar ruim agora melhorando novo 	Neutra	2	-2
superaram 	Neutra	1	-1
mapas offline validade 	Neutra	1	-1
ter opcao tirar 	Neutra	1	-1
realidade sao burros pois tudo desenvolvem atualizam travam celulares nao funcionam 	Negativo	1	-1
lamentavel 	Negativo	1	-1
regular ficou lento dessa atualizacao 	Negativo	1	-2
ainda precisa muita coisa antes bem melhor pq agente ia ate destino sair lugar agora nao opcao ainda existe muitas ruas agente nao consegue encontrar nao mostra nomes ruas proximas exemplo travessa cadê nome 	Negativo	2	-1
nao consigo usar ps 	Negativo	1	-1
porcaria botei destino beira mar parar boca fumo quase roubado moro fortaleza localizacao tava sul pais 	Negativo	1	-2
unico defeito vezes sinal some demora pouco voltar funcionar 	Negativo	1	-2
fazem uns dez meses trava direto zenfone 2 toda vez forcar parada 	Negativo	1	-1
coloquei 2 posts foruns (no internacional ingles local portugues) ninguem cara explicando porque opcao funcionalidade retirada 	Negativo	1	-1
l lento extremo 	Negativo	1	-2
ultima utilizacao ficou bosta ruim tao ruimestou usando outra vista google maps menos nao fica saindo sinal resumindo ta lixo 	Negativo	1	-2
apos atualizacao app nao vem funcionando bem desinstalar instalar novamente ver funciona caso contrario usar outro app 	Negativo	2	-1
porem ainda fica localizando locais impossiveis 	Negativo	1	-1
so demorando carregar demora achar cidades selecionadas usando net casa 8mb fibra optica 	Negativo	1	-1
baixem tom tom sim vale pena 	Negativo	1	-2
software lento muitas vezes operadora sinal porem aplicativo aparece procurando sinal 	Negativo	1	-2
algumas ruas aparecem mapa desaparecem durante navegacao 	Negativo	1	-1
pois dirijo apenas madrugada onde nao transito rota rapida nao sendo rapida dando muita volta necessidade precisa corrigir rapido possivel 	Negativo	1	-1
pessimo aplicativo 	Negativo	1	-1
app bug 	Negativo	1	-2
ultima atualizacao dando problemas bugs gps mapa nao gira pro lado indo 	Negativo	1	-1
agora so aparece falha comunicacao servidor rotas nao calcula rota nenhuma 	Negativo	1	-2
trabalho app demorando carregar destinos usuarios 	Negativo	1	-1
1 estrela so pois tiraram opcao rotas curtas rapidas zoom navegacao tbm aopcao taxi nao le corredores onibus 	Negativo	1	-1
app nao funcionando 	Negativo	1	-1
precisao ainda nao boa 	Negativo	2	-1
dentro carro 3h30 cheguei niteroi manilha 	Negativo	1	-1
nao consigo acessar absolutamente nenhuma funcionalidade malditos anuncios estao firmes fortes 	Negativo	1	-1
vezes nao encontra locais outros gps conseguem identificar facilmente 	Negativo	1	-1
continuam insistindo desgraca bola azul joga verdadeira loteria pra apostarmos acertarmos nao direcao correta pra seguir 	Negativo	1	-1
simplesmente porcaria 	Negativo	1	-1
navegando ponta cabeca 	Negativo	1	-1
valdeci bom ajuda celular esquenta tanto fica igual bola fogose cair agua cima ferve 	Negativo	2	-1
deixa mao 	Negativo	1	-1
so nao vou dar 5 estrelas motivo: dados moveis cai trava rota nao consegui ficar tempo offline vezes joga outros lugares acontece 	Negativo	1	-1
dificil acesso inicial 	Negativo	1	-1
atualizacao ver mapa horizontal ruim muitos elementos tela dificulta visualizacao 	Negativo	1	-2
ja bom agora ñ consigo configurar idioma pq ñ entra selecionado 	Negativo	2	-1
vezes google mapas ajuda melhor trajeto sp bairro morumbi waze jogou dentro favela paraisopolis cortar caminhoqndo vi ja nao jeito sair 	Negativo	2	-2
ja tentei configurar aplicativo sucesso 	Negativo	3	-1
espero resolvam problema porque afinal contas nao unica problema 	Negativo	1	-2
horrivel endereco aparece errado 	Negativo	1	-2
deixa desejar termos fluidez claro depende configuracao celular 	Negativo	1	-2
volta nao achei boa nao 	Negativo	2	-1
comecei contribuir google maps voces falaram iam dar 100 gigas armazenamento drive chegasse nivel 4 cheguei nao recebi muitas pessoas frustradas tambem voces derem armazenamento volto contribuir local guide 	Negativo	1	-1
ultima atualizacao ficou ruim achar enderecos corretos cidade 	Negativo	1	-2
porcaria travando direto 	Negativo	1	-1
fechando abrindo app nao captura sinal gps 	Negativo	1	-2
vez desliga sozinho dar nenhum comando precisam corrigir 	Negativo	1	-1
resumindo inutil 	Negativo	1	-1
iniciar navegacao nao atualiza comeca dirigir so tempo 	Negativo	1	-1
creio melhorar motorista uber 	Negativo	2	-1
propagandas sao chatissimas tambem 	Negativo	1	-1
nao fica portugues br 	Negativo	1	-1
versao obrigou apagar cache dados app funcionar 	Negativo	1	-2
so problema nao gostei voz comprei app tts nao fala português brasileiro claramente 	Negativo	3	-2
merda porcaria 	Negativo	1	-2
porcaria nao entende linha reta rua mostra dirigindo carro lado carrangueijo ja waze nao problemas 	Negativo	1	-1
nao verdade 	Negativo	2	-1
sempre usei maps infelizmente nao mostra percurso visao terrestre apenas visao aerea tornando trajeto tanto quanto complicado 	Negativo	1	-2
	Negativo	1	-1
muitas informacoes desnecessarias tela todo minuto ficar tirando mao volante pra apagar informacoes travando perdendo sinal gps ta pior piores ja melhor todos contrataram nerd pra estragar aplicativo 	Negativo	2	-3
nao funciona off line corretamente 	Negativo	1	-1
navegacao pessima dessa versao tal "bolinha azul" 	Negativo	1	-1
deveria mapear evitar areas risco menos alertar condutor vai entrar zona perigo 	Negativo	1	-2
apenas explique vantagem disso 	Negativo	1	-1
app fica buscando sinal gps toda hora 	Negativo	1	-1
precisando atualizar aparecendo rotas inexistentes linja tempo aponta lugares voce nao 	Negativo	1	-1
motivo nao uso frequencia consumo gigantesco bateria 	Negativo	1	-1
melhorar 	Negativo	2	-1
comentarios ja agradou hj so dor cabeca gastos vive sinal 	Negativo	1	-2
rotas longas vezes necessidade retorno nao fica procurando rede internet pleno funcionamento 	Negativo	1	-1
desinstalando vou comecar usar google maps 	Negativo	1	-1
porem algumas ressalvas horas demora atualizar fazemos conversao exemplo fazer outra logo seguida 	Negativo	1	-1
frita motog 2 alem celular esquentar ficou botoes ruins postar problemas 	Negativo	1	-1
vezes nao captura sinal gps faz abra mapsocorre normalmente ligo desligo gps celular visando economia bateria 	Negativo	1	-2
medo policia bandido avisar bandidos evitam policia continuam rua fator surpresa deve valer pra todos 	Negativo	1	-4
nao outro gps salvo smartphone nao chegado 	Negativo	1	-1
conseguiram piorar ja ruim 	Negativo	1	-2
nao consigo localizar 	Negativo	1	-1
nao antes trava nao reconhece trajeto determinadas cidades interior sao paulo ja passei problema desenvolvedores nao obtive retorno nao sei vou continuar 	Negativo	1	-2
so fica meio estranho algo lugares rota continua erro caminho diferente 	Negativo	1	-2
ponto fraco nao poder adicionar 10 paradas sistema bom	Negativo	2	-2
nunca vi coisa tao ruimfui localizar rua paes barros apareceu propaganda rabinos 	Negativo	1	-2
nao avisa sobre area risco carrega eternamente 	Negativo	1	-2
nao ta aparecendo rotas perto vc coloca pra ir pra lugar escolhe longe consertem rapido 	Negativo	1	-1
so atualizar algumas coisas 	Negativo	1	-1
trava demais 	Negativo	1	-1
porem ate hoje morga decisao google deixou oferecer premio surpresa pra conseguia alcancar nivel 5 deveriam voltar brindes contribue 	Negativo	1	-1
app trava orientacao imprecisa 	Negativo	1	-1
devia permitir fazer download mapa so gastar dados informacoes transito 	Negativo	1	-1
atualizacao app nao funciona direito 	Negativo	1	-2
vou tentar atualizacao pois atualizacoes anteriores bugs pois colocavam m ruas saida tempo chegada destino dando muitas discrepancias 	Negativo	1	-1
toda vez q app sofre update bagunca toda lista favoritos alterando ordem 	Negativo	1	-4
nao antes favor pessoal responsavel programacao ajeita ai favor 	Negativo	2	-2
apenas gostaria salientar nao acho interessante aplicativo disponibilizar possibilidade informar existencia viaturas policiais percurso facilita transito criminosos vai contra seguranca publica 	Negativo	1	-2
ultimamente ruim fica tempo todo tracando novas rotas lugares totalmente diferente destino 	Negativo	1	-2
ultima atualizacao ficou ruim usava uber agora demorademais carregar destino usando google ate arrumarem 	Negativo	1	-2
so faltou ter mudanca voz ainda nao sei app leve facil usar gostei 	Negativo	3	-1
usando google maps lugar wazer perdeu usuario atualizacao porca 	Negativo	1	-1
melhorar 	Negativo	2	-1
decepcao app google 	Negativo	1	-1
ja pensei trocar celular ja disseram problema waze passou nao prestar 	Negativo	1	-2
porcaria aqui nao serve gps 	Negativo	1	-1
toda hora "sem sinal gps" 	Negativo	1	-1
varias ruas numeros q nao batem local precisar ser atualizado acertar fica perfeito 	Negativo	2	-1
precisei desinstalar todas atualizacoes pra voltar normal 	Negativo	1	-1
desatualizado olhar hj dia 03/12/2017 umas fotos localizacao tudo antigas tanta atencao app ainda continua passado 0 estrela 	Negativo	1	-1
nao atualiza instalar bosta 	Negativo	1	-1
melhor ultimamente anda travando comeca dar problema nao carrega fechar app abrir novamente problema nao telefone pois outros aplicativos continuam rodando perfeitamente 	Negativo	2	-2
entao prejudicando bastante 	Negativo	1	-3
tambem bolinha hora iniciar dirigir nao ajuda nada pois gente nao sabe rumo gente deve iniciar 	Negativo	1	-2
deveriam dar ouvidos fizessem alguma mudanca vez acabam descredito ate desuso app 	Negativo	1	-1
retirada funcao menor trajeto prejudicando pois trabalho carro fez custos combustivel aumentasse 	Negativo	1	-3
destino tracado so consigo add umas paradas realizar buscas inves ver lista locais marcados clicar mapa 	Negativo	1	-1
ta ruim ja tempo nao atualiza desde ontem fica desligando reduz carro vezes tambem movimento aqui belo horizonte 	Negativo	1	-2
ultimas atualizacoes estragaram app melhor antes principalmente linha azul qi atrapalha navegacao   	Negativo	2	-1
amor deus 	Negativo	3	-1
levando locais incorretos aplicativo bom ultimas vezes utilizei levada locais errados caminhos longos trânsito 	Negativo	2	-1
quase morrerem 	Negativo	1	-1
to enfrentando problemas procurar bairros recentes ds cidade 	Negativo	1	-1
trava varias vezes nao causa internete 	Negativo	1	-1
so problemaa atualizacao mapa ja faz tempo mapas estao atualizar duas pontes novas marginal ja algum tempo mesmas ainda nao estao mapa 	Negativo	1	-2
atraso informacoes sobre localizacao apos ter passado rua fisicamente app ainda vou passear dando atraso 200m 	Negativo	1	-2
nao gostei colocou estrada terra 100 km 	Negativo	3	-1
diz q lugar nada ver onde realmente 	Negativo	1	-1
nao consegui escolher trajeto so deu duas opcoes fixas 	Negativo	1	-1
precisa atualizacao urgente 	Negativo	1	-1
rotas longas demoradas 	Negativo	1	-1
voce passa trajeto so mostra pra virar duas ruas antes 	Negativo	1	-1
ficou bolinha azul pessimo voltem antes agora deixo definitivamente usar 	Negativo	1	-1
opcao transporte publico porcaria 	Negativo	1	-1
nao atualizado 	Negativo	1	-1
horrivel pessimo 	Negativo	1	-1
aviso sonoro soa somente ter passado radar 	Negativo	1	-1
informacao poderia ter salvado vidas passado pode salvar vidas futuro 	Negativo	2	-1
nao interessante nao dar pra mudar rota adicionar paradas evitar alguma passagem alem ter interface basica menu suporte nao funciona 	Negativo	1	-2
agil recalcular nova rota porem colocou ruas contramao nao pode acontecer vindo app alta qualidade espero arrumado urgencia 	Negativo	1	-1
nao gostei tirado opcao escolher percurso rapido percurso curto 	Negativo	3	-1
porcaria 	Negativo	1	-1
nao consigo usar forma apropriada 	Negativo	1	-1
apenas gps nada incrivel brasileiro nao perde mania estragar funcionando so ser vendido simplesmente acabo otimo agr   pelo menos servido orientacao ai vc vê acontecendo sevira maluco menos mal 	Negativo	1	-3
amor deus consertem logo 	Negativo	3	-1
erros sentido transito rio janeiro certos pontos 	Negativo	1	-1
horrivel trava tempo todo 	Negativo	1	-1
deppis desta ultima atualizacao trajeto atrasado alias atrasado voce entra rua ainda quadra atras pensando 	Negativo	1	-2
app ta bugado mapa nao aparece tela msm wifi gps alta precisao 	Negativo	1	-1
moro genevesuica mes ca nao aparece opcoes pra pegar bus trem convencional 	Negativo	1	-1
so caminhos faceis nao indica exemplo leopoldina mg virginopolis andei 50 km sendo passando ipatinga google maps andei 50 km menos poderia dar todas opcoes rotas 	Negativo	1	-1
momentos some 	Negativo	1	-1
podia ser melhor atualizado 	Negativo	2	-1
to avaliando ruim porque celula ta fucionando nao aparece mapa muda ingles portugues 	Negativo	1	-2
dessa suposta atualizacao corrigir "erros" maps ficou errado nunca 	Negativo	1	-2
ja bom 	Negativo	2	-1
atencao devops: app acabando bateria celular 1h msm utilizando carregador veicular 	Negativo	1	-1
todas vezes troquei celular nao pra recuperar conta antiga acha logo aparece problema fazer nova 	Negativo	1	-2
ate desgosto ter app celular melhorem favor 	Negativo	2	-4
pena litoral sul bahia precisamente br 327 sentido porto seguro nao reconhece radares fica desorientado trajeto 	Negativo	2	-2
so nao dei 5 estrelas muitas vezes nao acha sinal gps q ligar internet pra achar fica escrito assim "opps nao encontramos sinal gps" manda mudar destino 	Negativo	1	-1
falha zenfone 5 asus lerdo nao carrega direito precisa arrumar urgente pois apo util funciona direito 	Negativo	1	-2
apos ultima atualizacao continua pessimo 	Negativo	1	-1
so dia pro outro opcao rodizio sumiu waze 	Negativo	1	-1
hj dia perdeu qualidade 	Negativo	1	-1
horrivel conectividade encontrar localizacao atual vezes preciso ficar parados espera tracar rota nao traca so minutos voce andando destino 	Negativo	2	-1
portanto preferido google maps 	Negativo	1	-1
preciso atrapalha 	Negativo	1	-1
perde pro waze nesse sentido 	Negativo	1	-2
porem consome muita bateria pacote dados 	Negativo	1	-1
nao compensa sempre mostra rota dificil maior nao pratico 	Negativo	1	-1
dps atualizacao app fecha sozinho fica travando toda hora trabalho mobilidade urbana antes waze melhor duvida agora so usando maps 	Negativo	2	-1
cai sinal gps demora atualizar rota vc sai percurso 	Negativo	1	-1
fiquei pouco preocupado app levou lugar diferente 	Negativo	1	-1
ja tentei novas configuracoes nao adiantou 	Negativo	1	-1
app parandoquando chego determinado lugar pede pra tirar foto funcionar 	Negativo	1	-1
desti jeito nao recomendo 	Negativo	1	-1
